TGCTGAAACCAAAGTTGAC -> GCTGAAACCAAAGTTGACT
CGGGAAATACACAGGCTGG -> GGGAAATACACAGGCTGGC
CCCATCTCAGTCTATGCTC -> CCATCTCAGTCTATGCTCA
CCGCCGTGTGGTCCGCGCC -> CGCCGTGTGGTCCGCGCCT
CATGGGAAAATCGAGCCGA -> ATGGGAAAATCGAGCCGAT
GCTAGAAGAGTAAATAATT -> CTAGAAGAGTAAATAATTT
GAGAAGCATAACTGCCCAG -> AGAAGCATAACTGCCCAGC
AACCGCGCCTTCCATATCC -> ACCGCGCCTTCCATATCCC
CCACAGAAACGGTTGGCCA -> CACAGAAACGGTTGGCCAG
TTAACAACGGGAAATACAC -> TAACAACGGGAAATACACA
TTGTACACACCTCGTCTGG -> TGTACACACCTCGTCTGGG
CAAGATGGAACCGGTTTCG -> AAGATGGAACCGGTTTCGT
GCCGCGCCTTCCATATCCC -> CCGCGCCTTCCATATCCCG
GCTGGCTAATGCTTGATCC -> CTGGCTAATGCTTGATCCG
GAGAGATAGAATACAAGGT -> AGAGATAGAATACAAGGTA
CACTCGTGGTCACAGTGGT -> ACTCGTGGTCACAGTGGTG
GGCCTCAATCTGACGAACC -> GCCTCAATCTGACGAACCC
GTGAAAGAACCGCTGTGCT -> TGAAAGAACCGCTGTGCTG
CCCGCTAGAAGAGTAAATA -> CCGCTAGAAGAGTAAATAA
AGTTTACGAAGCAGCAGGT -> GTTTACGAAGCAGCAGGTC
CGCTAGTGTCCCCGTGTCG -> GCTAGTGTCCCCGTGTCGA
CCCGCAATTAGAGTTTACG -> CCGCAATTAGAGTTTACGA
ACACAGGCTGTGGAAATAC -> CACAGGCTGTGGAAATACA
CAGTGTGTTATAATGACGA -> AGTGTGTTATAATGACGAT
CCCGTGTCGAGCGATGAGC -> CCGTGTCGAGCGATGAGCT
GCCTGCTGGACCACACGAA -> CCTGCTGGACCACACGAAG
TGTCCGTAGAAGCGGTGCG -> GTCCGTAGAAGCGGTGCGG
ATATGTGGAAGTCTGGTAT -> TATGTGGAAGTCTGGTATG
TAGTGGTCCGCCTTTATAC -> AGTGGTCCGCCTTTATACC
TGTACACACCTCGTCTGGG -> GTACACACCTCGTCTGGGT
AAACTGTGCTCCAGTGCCT -> AACTGTGCTCCAGTGCCTG
AATGAGATGATAGCTCGCG -> ATGAGATGATAGCTCGCGC
GACTTACTAATTCCGGTCG -> ACTTACTAATTCCGGTCGG
ACGAATAGTACGTATTGTA -> CGAATAGTACGTATTGTAC
CTATGATGGCCTTGCGCGC -> TATGATGGCCTTGCGCGCC
ATGAGATGATAGCTCGCGC -> TGAGATGATAGCTCGCGCT
CAGTTGTTTACGACCCGCA -> AGTTGTTTACGACCCGCAA
CATAACTGCCCAGCTTTAA -> ATAACTGCCCAGCTTTAAC
TGCGGGAATTTGTGGACCC -> GCGGGAATTTGTGGACCCG
AGGCACGGCTATTCGTACG -> GGCACGGCTATTCGTACGT
CTCTGCGACTGTTTCACTC -> TCTGCGACTGTTTCACTCA
CGAACCCATCAAAACATGC -> GAACCCATCAAAACATGCG
GTCTGGCCTGTATGTTAAG -> TCTGGCCTGTATGTTAAGG
AGAGTAAATAATTTTGTCG -> GAGTAAATAATTTTGTCGA
CCCTATGTGTCAAGATGGA -> CCTATGTGTCAAGATGGAA
TGTTATAATGACGATAATC -> GTTATAATGACGATAATCA
CAGTGGTGACGAATGTCCG -> AGTGGTGACGAATGTCCGT
AGTCTGGTATGAGTATTTT -> GTCTGGTATGAGTATTTTG
CATGCGGGAATTTGTGGAC -> ATGCGGGAATTTGTGGACC
CTCACTCTATATCAGCGCT -> TCACTCTATATCAGCGCTC
CGTTGATTGGAGACGTCAC -> GTTGATTGGAGACGTCACC
CGCTCTACGCCACTACGAA -> GCTCTACGCCACTACGAAG
CGAGGTGATTGCAGGCGCT -> GAGGTGATTGCAGGCGCTC
CCATCGTAGAACGTTGATT -> CATCGTAGAACGTTGATTG
GATAATCACACAGTCAGAG -> ATAATCACACAGTCAGAGG
TCTGGGTAGTTCTCCCATC -> CTGGGTAGTTCTCCCATCT
CCCCTATGTGTCAAGATGG -> CCCTATGTGTCAAGATGGA
GGACTCTACCAACCCTTAC -> GACTCTACCAACCCTTACG
AAAACCATCGTAGAACGTT -> AAACCATCGTAGAACGTTG
AGCGATGAGCTCTGCGACT -> GCGATGAGCTCTGCGACTG
CCCCCTCAGCGCCGGCTGA -> CCCCTCAGCGCCGGCTGAG
ATTAGGTGTATGAATCTGG -> TTAGGTGTATGAATCTGGA
GACTCAAGCAAGCCGGAAC -> ACTCAAGCAAGCCGGAACT
TAACTCATTATCAGCTCAC -> AACTCATTATCAGCTCACA
CGCCTTTATACCATCACAA -> GCCTTTATACCATCACAAA
CTCAAATAACTCATTATCA -> TCAAATAACTCATTATCAG
GGTAGTCCGTACGGAGTCT -> GTAGTCCGTACGGAGTCTC
TCCAGTGCCTGGAGCTTTT -> CCAGTGCCTGGAGCTTTTG
TACGTATTGTACACACCTC -> ACGTATTGTACACACCTCG
ACTTACTAATTCCGGTCGG -> CTTACTAATTCCGGTCGGT
TTTCGCGGCTTAACAACGG -> TTCGCGGCTTAACAACGGG
TCGCTCGGTTTGGTTTACC -> CGCTCGGTTTGGTTTACCC
AGCTCGCGCTAGTGTCCCC -> GCTCGCGCTAGTGTCCCCG
ATCTTATCCGCCGCCCCTA -> TCTTATCCGCCGCCCCTAT
CAAAACCATCGTAGAACGT -> AAAACCATCGTAGAACGTT
GCTAATCGACAAACTGTGC -> CTAATCGACAAACTGTGCT
GGATGCTCCTAAACATGGT -> GATGCTCCTAAACATGGTT
AACCGGTTTCGTCCGCTTC -> ACCGGTTTCGTCCGCTTCT
AATCTTATCCGCCGCCCCT -> ATCTTATCCGCCGCCCCTA
TCTACGCCACTACGAAGGC -> CTACGCCACTACGAAGGCC
TCGGTGAATGCCACTATGA -> CGGTGAATGCCACTATGAT
CGCACGCAGCAGCATTCAC -> GCACGCAGCAGCATTCACG
GATATGTCTGAGGATGCTC -> ATATGTCTGAGGATGCTCC
ATGGCCTTGCGCGCCAGGT -> TGGCCTTGCGCGCCAGGTT
CGTACGGAGTCTCCAACAC -> GTACGGAGTCTCCAACACT
TAGTCCGTACGGAGTCTCC -> AGTCCGTACGGAGTCTCCA
CAATCTGACGAACCCATCA -> AATCTGACGAACCCATCAA
CCCTCTCACTCAGGCATTT -> CCTCTCACTCAGGCATTTT
TTCTCCCATCTCAGTCTAT -> TCTCCCATCTCAGTCTATG
AGAACCGCTGTGCTGAAAC -> GAACCGCTGTGCTGAAACC
GCAATCTTATCCGCCGCCC -> CAATCTTATCCGCCGCCCC
GCACCGGCGTAAACCGCGC -> CACCGGCGTAAACCGCGCC
GTACGCACACTCAGTCGAT -> TACGCACACTCAGTCGATT
CTATTGGTGACGTACGACG -> TATTGGTGACGTACGACGT
CTTCCATATCCCGCTAGAA -> TTCCATATCCCGCTAGAAG
ACCGTCCCTGAAATTGGCG -> CCGTCCCTGAAATTGGCGT
CCCGCAGTGACGAATAGTA -> CCGCAGTGACGAATAGTAC
TATACGGCCTCAATCTGAC -> ATACGGCCTCAATCTGACG
AATGTCCGTAGAAGCGGTG -> ATGTCCGTAGAAGCGGTGC
TATTCCCTATTGGTGACGT -> ATTCCCTATTGGTGACGTA
CATAACGCGGCAGAACCTC -> ATAACGCGGCAGAACCTCC
CCACTACGAAGGCCTATCG -> CACTACGAAGGCCTATCGA
CACCGGTAGCGGGTTTGGT -> ACCGGTAGCGGGTTTGGTC
GCACCGTCCCTGAAATTGG -> CACCGTCCCTGAAATTGGC
GAATTAGGGACGAGGTTCA -> AATTAGGGACGAGGTTCAA
GACTGTTTCACTCACTCTA -> ACTGTTTCACTCACTCTAT
ATCCCTATGCGTGGGGACT -> TCCCTATGCGTGGGGACTT
GCCGGCTGAGAAGCATAAC -> CCGGCTGAGAAGCATAACT
ACTCAGGCATTTTGGTAGC -> CTCAGGCATTTTGGTAGCA
TGGAGGTGGCTGAGAAACT -> GGAGGTGGCTGAGAAACTG
CAGGCATTTTGGTAGCAAC -> AGGCATTTTGGTAGCAACG
GTTCTCGTATGCGCACGCA -> TTCTCGTATGCGCACGCAG
ATCCGCCGCCCCTATGTGT -> TCCGCCGCCCCTATGTGTC
GCCCCGAGGAAAACGGACT -> CCCCGAGGAAAACGGACTT
GGGTAGTTCTCCCATCTCA -> GGTAGTTCTCCCATCTCAG
GCACACTTCTTGAGATTAA -> CACACTTCTTGAGATTAAC
GACGAGGTTCAACACACAG -> ACGAGGTTCAACACACAGA
CTGCGACTGTTTCACTCAC -> TGCGACTGTTTCACTCACT
CGGAAGTGGAGGTGGCTGA -> GGAAGTGGAGGTGGCTGAG
ACCACACGAAGTGTGTGAA -> CCACACGAAGTGTGTGAAA
CGATTCCATGCACCGTCCC -> GATTCCATGCACCGTCCCT
GTCTTTGCGTGGATTACCT -> TCTTTGCGTGGATTACCTT
AATTAGGTGTATGAATCTG -> ATTAGGTGTATGAATCTGG
GTCGATTCCATGCACCGTC -> TCGATTCCATGCACCGTCC
AGGATGACAAAACCATCGT -> GGATGACAAAACCATCGTA
CCTATGTGTCAAGATGGAA -> CTATGTGTCAAGATGGAAC
TTGGTAGCTACCGGTGGGC -> TGGTAGCTACCGGTGGGCT
TGGAAATACACAGGCTGGC -> GGAAATACACAGGCTGGCT
CCGCTTCTACGGTTCTCAG -> CGCTTCTACGGTTCTCAGA
CCTAGGGTTCAAAGGCAGT -> CTAGGGTTCAAAGGCAGTA
GCAGTGCAAGCCCCGAGGA -> CAGTGCAAGCCCCGAGGAA
ACGATAATCACACAGTCAG -> CGATAATCACACAGTCAGA
TGGTCTTTGTTTTTTTCGC -> GGTCTTTGTTTTTTTCGCG
CAGTCAGAGGCTAGCAGAA -> AGTCAGAGGCTAGCAGAAT
TAGGGTTCAAAGGCAGTAA -> AGGGTTCAAAGGCAGTAAA
CTGGCCTGTATGTTAAGGT -> TGGCCTGTATGTTAAGGTC
CCTAGGACGAGTAGACTGT -> CTAGGACGAGTAGACTGTA
CCGTGTCGAGCGATGAGCT -> CGTGTCGAGCGATGAGCTC
TATATCAGCGCTCTACGCC -> ATATCAGCGCTCTACGCCA
GGAACTTTGTCGACAGAAA -> GAACTTTGTCGACAGAAAT
AAGAAGCTGAAATTAAGCA -> AGAAGCTGAAATTAAGCAT
CATGCTAAGAGAGATAGAA -> ATGCTAAGAGAGATAGAAT
CTTCGAGAACTCCACCCAG -> TTCGAGAACTCCACCCAGT
CTCGTATGCGCACGCAGCA -> TCGTATGCGCACGCAGCAG
CAGTGCCTGGAGCTTTTGG -> AGTGCCTGGAGCTTTTGGC
TTCGGTCTGCAACTCCTGG -> TCGGTCTGCAACTCCTGGT
ATTCTCTATGATGCTAATG -> TTCTCTATGATGCTAATGG
CCGGAAATACACAGGCTGT -> CGGAAATACACAGGCTGTG
AGTCCGTACGGAGTCTCCA -> GTCCGTACGGAGTCTCCAA
TTCTCAGACGCTTATGCCG -> TCTCAGACGCTTATGCCGT
GTGACGAATGTCCGTAGAA -> TGACGAATGTCCGTAGAAG
GTTACATTCTTATGGCGTG -> TTACATTCTTATGGCGTGG
GAAGCTGAAATTAAGCATT -> AAGCTGAAATTAAGCATTC
CTAATTCCGGTCGGTCTTT -> TAATTCCGGTCGGTCTTTG
CATCTCAGTCTATGCTCAG -> ATCTCAGTCTATGCTCAGG
TACACAGGCTGTGGAAATA -> ACACAGGCTGTGGAAATAC
GTACGACGTGAGGTAAGGC -> TACGACGTGAGGTAAGGCA
CCACACGAAGTGTGTGAAA -> CACACGAAGTGTGTGAAAG
TAGAGTTTACGAAGCAGCA -> AGAGTTTACGAAGCAGCAG
TTACTAATTCCGGTCGGTC -> TACTAATTCCGGTCGGTCT
GAATGCCACTATGATGGCC -> AATGCCACTATGATGGCCT
GTCCCCGTGTCGAGCGATG -> TCCCCGTGTCGAGCGATGA
ACCGCTGTGCTGAAACCAA -> CCGCTGTGCTGAAACCAAA
AAATACACAGGCTGGCTAA -> AATACACAGGCTGGCTAAT
GTAACCGGAAATACACAGG -> TAACCGGAAATACACAGGC
CGAGGTTCAACACACAGAT -> GAGGTTCAACACACAGATT
AGTAGACTGTATACGGCCT -> GTAGACTGTATACGGCCTC
AAGAATTAGGTGTATGAAT -> AGAATTAGGTGTATGAATC
AGATTACGCCTCTGCGTCT -> GATTACGCCTCTGCGTCTG
TACCCGTAGAGGCACGGCT -> ACCCGTAGAGGCACGGCTA
GGCGCTCGGAATTAACTCT -> GCGCTCGGAATTAACTCTC
CGGTCTGCAACTCCTGGTA -> GGTCTGCAACTCCTGGTAG
TTTGCGTGGATTACCTTTT -> TTGCGTGGATTACCTTTTT
CAGAAATCACCCGAGGCCC -> AGAAATCACCCGAGGCCCG
CTGTGCTGAAACCAAAGTT -> TGTGCTGAAACCAAAGTTG
CGACAAACTGTGCTCCAGT -> GACAAACTGTGCTCCAGTG
GTGGTGACGAATGTCCGTA -> TGGTGACGAATGTCCGTAG
ATACCATCACAAAAGCGTG -> TACCATCACAAAAGCGTGT
CGACTCAAGCAAGCCGGAA -> GACTCAAGCAAGCCGGAAC
CGTTAAGCACCATCATGAG -> GTTAAGCACCATCATGAGT
CCATGCACCGTCCCTGAAA -> CATGCACCGTCCCTGAAAT
GAAATACACAGGCTGGCAC -> AAATACACAGGCTGGCACC
AAATAATTTTGTCGATTCC -> AATAATTTTGTCGATTCCA
TAGAGGCACGGCTATTCGT -> AGAGGCACGGCTATTCGTA
AGCGGTGCGGGTTACATTC -> GCGGTGCGGGTTACATTCT
CTGAGGATGCTCCTAAACA -> TGAGGATGCTCCTAAACAT
TACCGGTGGGCTAATCGAC -> ACCGGTGGGCTAATCGACA
GTCTGGTATGAGTATTTTG -> TCTGGTATGAGTATTTTGC
CTATGCTCAGGGACTCTAC -> TATGCTCAGGGACTCTACC
AACTCATTATCAGCTCACA -> ACTCATTATCAGCTCACAA
GTAGACTGTATACGGCCTC -> TAGACTGTATACGGCCTCA
GTCGGTAGTCCGTACGGAG -> TCGGTAGTCCGTACGGAGT
GCTCGCGCTAGTGTCCCCG -> CTCGCGCTAGTGTCCCCGT
ATGAGTGTCGACCTAATCC -> TGAGTGTCGACCTAATCCC
TCCGCGCCTTCCATATCCC -> CCGCGCCTTCCATATCCCG, CCGCGCCTTCCATATCCCG
TCGGAAGTGGAGGTGGCTG -> CGGAAGTGGAGGTGGCTGA
GGAAATACACAGGCTGGCG -> GAAATACACAGGCTGGCGA
GGCGAGGGAGGGAGCCGCG -> GCGAGGGAGGGAGCCGCGC
TTTTTTCGCGGCTTAACAA -> TTTTTCGCGGCTTAACAAC
CGGACTTACTAATTCCGGT -> GGACTTACTAATTCCGGTC
GGGTTACATTCTTATGGCG -> GGTTACATTCTTATGGCGT
TCCTGGTAGTGGTCCGCCT -> CCTGGTAGTGGTCCGCCTT
TAGGGACGAGGTTCAACAC -> AGGGACGAGGTTCAACACA
TTGAGATTAACAGTGTGTT -> TGAGATTAACAGTGTGTTA
CACAGGCTGGCGAGGGAGG -> ACAGGCTGGCGAGGGAGGG
ATGATGCTAATGGAGTCAT -> TGATGCTAATGGAGTCATG
GAGAACTCCACCCAGTTCC -> AGAACTCCACCCAGTTCCT
CTTGCGCGCCAGGTTACGT -> TTGCGCGCCAGGTTACGTT
ATCCCGGGCTGCCATGGGA -> TCCCGGGCTGCCATGGGAA
GGCGTGGATCTCGCCGTTA -> GCGTGGATCTCGCCGTTAA
CTTACGGTATTCACTCGTG -> TTACGGTATTCACTCGTGG
CCCCGAGGAAAACGGACTT -> CCCGAGGAAAACGGACTTA
TGCGTGGGGACTTTAGTGC -> GCGTGGGGACTTTAGTGCC
GAGATGATAGCTCGCGCTA -> AGATGATAGCTCGCGCTAG
TACGGTATTCACTCGTGGT -> ACGGTATTCACTCGTGGTC
TAAGAGAGATAGAATACAA -> AAGAGAGATAGAATACAAG
CAGAGAGGTGCCCCCTCAG -> AGAGAGGTGCCCCCTCAGC
TCGCCGTTAAGCACCATCA -> CGCCGTTAAGCACCATCAT
CGTAGAAGCGGTGCGGGTT -> GTAGAAGCGGTGCGGGTTA
CGTGGATTACCTTTTTATA -> GTGGATTACCTTTTTATAA
TACGGCCTCAATCTGACGA -> ACGGCCTCAATCTGACGAA
GGTGGGCTAATCGACAAAC -> GTGGGCTAATCGACAAACT
TAATCACACAGTCAGAGGC -> AATCACACAGTCAGAGGCT
AGTGCCTGGAGCTTTTGGC -> GTGCCTGGAGCTTTTGGCA
AGTTGACTGCGGGCGTCCC -> GTTGACTGCGGGCGTCCCA
CGGTAGCGGGTTTGGTCTT -> GGTAGCGGGTTTGGTCTTT
CTACGCCACTACGAAGGCC -> TACGCCACTACGAAGGCCT
CAAGGTACGCACACTCAGT -> AAGGTACGCACACTCAGTC
AAATCACCCGAGGCCCGTG -> AATCACCCGAGGCCCGTGC
ATTAGGGACGAGGTTCAAC -> TTAGGGACGAGGTTCAACA
TACGCCTCTGCGTCTGGCC -> ACGCCTCTGCGTCTGGCCT
ACCAACCCTTACGGAGTTA -> CCAACCCTTACGGAGTTAA
AGGTGGCTGAGAAACTGTG -> GGTGGCTGAGAAACTGTGT
TAATGGCAGAGAGGTGCCC -> AATGGCAGAGAGGTGCCCC
ATGTTAAGGTCCATATGTG -> TGTTAAGGTCCATATGTGG
AATTGGCGTCCTAGGGTTC -> ATTGGCGTCCTAGGGTTCA
GTCCATATGTGGAAGTCTG -> TCCATATGTGGAAGTCTGG
CTGTGTTCTCGTATGCGCA -> TGTGTTCTCGTATGCGCAC
TGTCGATTCCATGCACCGT -> GTCGATTCCATGCACCGTC
CAGGTTACGTTTATCCCGG -> AGGTTACGTTTATCCCGGG
GACGAGTAGACTGTATACG -> ACGAGTAGACTGTATACGG
AGAGGTGCCCCCTCAGCGC -> GAGGTGCCCCCTCAGCGCC
ACGAAGGCCTATCGACTTC -> CGAAGGCCTATCGACTTCG
CCTTCCATATCCCGCAGTG -> CTTCCATATCCCGCAGTGA
ACCCAGTTCCTGCACGACT -> CCCAGTTCCTGCACGACTC
CAAATAACTCATTATCAGC -> AAATAACTCATTATCAGCT
TGGCCTTGCGCGCCAGGTT -> GGCCTTGCGCGCCAGGTTA
AACCGCAGTGCAAGCCCCG -> ACCGCAGTGCAAGCCCCGA
ATAGCTCGCGCTAGTGTCC -> TAGCTCGCGCTAGTGTCCC
CTTTGTTTTTTTCGCGGCT -> TTTGTTTTTTTCGCGGCTT
GCGACTGTTTCACTCACTC -> CGACTGTTTCACTCACTCT
TAAATAATTTTGTCGATTC -> AAATAATTTTGTCGATTCC
TATCCCGCCTTACGGTATT -> ATCCCGCCTTACGGTATTC
CCCTATTGGTGACGTACGA -> CCTATTGGTGACGTACGAC
TACGAAGGCCTATCGACTT -> ACGAAGGCCTATCGACTTC
GAACCCATCAAAACATGCG -> AACCCATCAAAACATGCGG
GGTATGAGTATTTTGCAGG -> GTATGAGTATTTTGCAGGA
TCTGCAACTCCTGGTAGTG -> CTGCAACTCCTGGTAGTGG
ATGAATCTGGATCAGCTCG -> TGAATCTGGATCAGCTCGT
AGTTAAAAATCAGTGCGCA -> GTTAAAAATCAGTGCGCAT
AGCTCACAAGAAGCTGAAA -> GCTCACAAGAAGCTGAAAT
ACTTTAGTGCCAGTTGTTT -> CTTTAGTGCCAGTTGTTTA
TTGACCACAGGATGACAAA -> TGACCACAGGATGACAAAA
AGCAGCATTCACGCCTTCG -> GCAGCATTCACGCCTTCGG
TTATACCATCACAAAAGCG -> TATACCATCACAAAAGCGT
TCGTAGAACGTTGATTGGA -> CGTAGAACGTTGATTGGAG
GGCTGGCACCGGCGTAAAC -> GCTGGCACCGGCGTAAACC
AGAGATAGAATACAAGGTA -> GAGATAGAATACAAGGTAC
AGGTCCATATGTGGAAGTC -> GGTCCATATGTGGAAGTCT
ATCAGCGCTCTACGCCACT -> TCAGCGCTCTACGCCACTA
TTATTCCCTATTGGTGACG -> TATTCCCTATTGGTGACGT
CGAAGGCCTATCGACTTCG -> GAAGGCCTATCGACTTCGA
GAAATTAAGCATTCTCTAT -> AAATTAAGCATTCTCTATG
GCAGATCTAATGGCAGAGA -> CAGATCTAATGGCAGAGAG
GCTGAAATTAAGCATTCTC -> CTGAAATTAAGCATTCTCT
GCAGTTCGGTGAATGCCAC -> CAGTTCGGTGAATGCCACT
GTCGAGCGATGAGCTCTGC -> TCGAGCGATGAGCTCTGCG
CGCCCCTATGTGTCAAGAT -> GCCCCTATGTGTCAAGATG
CAACGAACATGCTAAGAGA -> AACGAACATGCTAAGAGAG
TTCAACACACAGATTACGC -> TCAACACACAGATTACGCC
ATTAAGCATTCTCTATGAT -> TTAAGCATTCTCTATGATG
AATCACACAGTCAGAGGCT -> ATCACACAGTCAGAGGCTA
TATCCCGCAGTGACGAATA -> ATCCCGCAGTGACGAATAG
ACCGGTGGGCTAATCGACA -> CCGGTGGGCTAATCGACAA
CCGAGTTGACCACAGGATG -> CGAGTTGACCACAGGATGA
CCGGTCGGTCTTTGCGTGG -> CGGTCGGTCTTTGCGTGGA
GTAGAGGCACGGCTATTCG -> TAGAGGCACGGCTATTCGT
GCGGCAGAACCTCCCCGTT -> CGGCAGAACCTCCCCGTTT
TATGGCGTGGATCTCGCCG -> ATGGCGTGGATCTCGCCGT
AATCACCCGAGGCCCGTGC -> ATCACCCGAGGCCCGTGCG
CTTTAACCCTCTCACTCAG -> TTTAACCCTCTCACTCAGG
GCCTTCGGTCTGCAACTCC -> CCTTCGGTCTGCAACTCCT
CCGCGCCTTCCATATCCCG -> CGCGCCTTCCATATCCCGC, CGCGCCTTCCATATCCCGC, CGCGCCTTCCATATCCCGG, CGCGCCTTCCATATCCCGC
GGCGTCCTAGGGTTCAAAG -> GCGTCCTAGGGTTCAAAGG
TTTCACTCACTCTATATCA -> TTCACTCACTCTATATCAG
GGCATTTTGGTAGCAACGA -> GCATTTTGGTAGCAACGAA
CTCTACGCCACTACGAAGG -> TCTACGCCACTACGAAGGC
GTGCGCATAACTCTAGTGA -> TGCGCATAACTCTAGTGAG
GGACGTGCCTAGGACGAGT -> GACGTGCCTAGGACGAGTA
TACAAGGTACGCACACTCA -> ACAAGGTACGCACACTCAG
TTTTTCGCGGCTTAACAAC -> TTTTCGCGGCTTAACAACG
AGATGATAGCTCGCGCTAG -> GATGATAGCTCGCGCTAGT
CTTGGTAGCTACCGGTGGG -> TTGGTAGCTACCGGTGGGC
CGTCACCGGTAGCGGGTTT -> GTCACCGGTAGCGGGTTTG
GCGCACGCAGCAGCATTCA -> CGCACGCAGCAGCATTCAC
CGTACGTGTACTGTCGGCG -> GTACGTGTACTGTCGGCGT
TTCAAAGGCAGTAAATGTA -> TCAAAGGCAGTAAATGTAA
GCGCCTTCCATATCCCGCC -> CGCCTTCCATATCCCGCCT
GGGAGGGAGCCGCGCCTTC -> GGAGGGAGCCGCGCCTTCC
ACGGAGTTAAAAATCAGTG -> CGGAGTTAAAAATCAGTGC
GCGCTAGTGTCCCCGTGTC -> CGCTAGTGTCCCCGTGTCG
TGAGATTAACAGTGTGTTA -> GAGATTAACAGTGTGTTAT
GGAAAACGGACTTACTAAT -> GAAAACGGACTTACTAATT
CCTTTTTATAAACAGTAAC -> CTTTTTATAAACAGTAACC
GGGAATTTGTGGACCCGCA -> GGAATTTGTGGACCCGCAA
ACCTTTTTATAAACAGTAA -> CCTTTTTATAAACAGTAAC
CATGGTTAATGAGATGATA -> ATGGTTAATGAGATGATAG
TGTGGTCCGCGCCTTCCAT -> GTGGTCCGCGCCTTCCATA
GAAACCAAAGTTGACTGCG -> AAACCAAAGTTGACTGCGG
AGCGCCGGCTGAGAAGCAT -> GCGCCGGCTGAGAAGCATA
GTGTATGAATCTGGATCAG -> TGTATGAATCTGGATCAGC
CCGTTAAGCACCATCATGA -> CGTTAAGCACCATCATGAG
CGTCCCTGAAATTGGCGTC -> GTCCCTGAAATTGGCGTCC
GAGTCATGTCTCGATCGTC -> AGTCATGTCTCGATCGTCG
TGCAAGCCCCGAGGAAAAC -> GCAAGCCCCGAGGAAAACG
CGACTTCGAGAACTCCACC -> GACTTCGAGAACTCCACCC
ATCACCCGAGGCCCGTGCG -> TCACCCGAGGCCCGTGCGA
GTTTCACTCACTCTATATC -> TTTCACTCACTCTATATCA
TCTGGCCTGTATGTTAAGG -> CTGGCCTGTATGTTAAGGT
CCTGCACGACTCAAGCAAG -> CTGCACGACTCAAGCAAGC
CCGGGCTGCCATGGGAAAA -> CGGGCTGCCATGGGAAAAT
CTGGCTAATGCTTGATCCG -> TGGCTAATGCTTGATCCGC
TATCCCGGCCGCCGTGTGG -> ATCCCGGCCGCCGTGTGGT
CCGCCTTTATACCATCACA -> CGCCTTTATACCATCACAA
GAGTAAATAATTTTGTCGA -> AGTAAATAATTTTGTCGAT
TCTATGCTCAGGGACTCTA -> CTATGCTCAGGGACTCTAC
GCTCACAAGAAGCTGAAAT -> CTCACAAGAAGCTGAAATT
TAAGCACCATCATGAGTGT -> AAGCACCATCATGAGTGTC
TCTCAAATAACTCATTATC -> CTCAAATAACTCATTATCA
TTTTGCAGGAGCTCTCAAC -> TTTGCAGGAGCTCTCAACC
CCGCTAGAAGAGTAAATAA -> CGCTAGAAGAGTAAATAAT
ACGACGTGAGGTAAGGCAA -> CGACGTGAGGTAAGGCAAT
AGCAGTTCGGTGAATGCCA -> GCAGTTCGGTGAATGCCAC
ATTCACGCCTTCGGTCTGC -> TTCACGCCTTCGGTCTGCA
CAGGCTGGCGAGGGAGGGA -> AGGCTGGCGAGGGAGGGAG
GTTACGTTTATCCCGGGCT -> TTACGTTTATCCCGGGCTG
TGGGCTAATCGACAAACTG -> GGGCTAATCGACAAACTGT
TGTATGTTAAGGTCCATAT -> GTATGTTAAGGTCCATATG
CCACGGGCCACAGAAACGG -> CACGGGCCACAGAAACGGT
GTCGCTTGGTAGCTACCGG -> TCGCTTGGTAGCTACCGGT
CACCGGCGTAAACCGCGCC -> ACCGGCGTAAACCGCGCCT
CGATGAGCTCTGCGACTGT -> GATGAGCTCTGCGACTGTT
TCGACCTAATCCCTATGCG -> CGACCTAATCCCTATGCGT
GACGTGCCTAGGACGAGTA -> ACGTGCCTAGGACGAGTAG
CTGTGGAAATACACAGGCT -> TGTGGAAATACACAGGCTG
ACCTCCCCGTTTTCGCATA -> CCTCCCCGTTTTCGCATAT
CAGTGACGAATAGTACGTA -> AGTGACGAATAGTACGTAT
AGTTCTCCCATCTCAGTCT -> GTTCTCCCATCTCAGTCTA
GAATTTGTGGACCCGCAAA -> AATTTGTGGACCCGCAAAG
TGACGAATGTCCGTAGAAG -> GACGAATGTCCGTAGAAGC
TTTAGTGCCAGTTGTTTAC -> TTAGTGCCAGTTGTTTACG
AAATTGGCGTCCTAGGGTT -> AATTGGCGTCCTAGGGTTC
CGGAATTAACTCTCATGCC -> GGAATTAACTCTCATGCCA
GTAAACCGCGCCTTCCATA -> TAAACCGCGCCTTCCATAT
CAGGCTGTGGAAATACACA -> AGGCTGTGGAAATACACAG
AGTCAGAGGCTAGCAGAAT -> GTCAGAGGCTAGCAGAATT
CAGCTTTAACCCTCTCACT -> AGCTTTAACCCTCTCACTC
ACATGGTTAATGAGATGAT -> CATGGTTAATGAGATGATA
ACCGGCGTAAACCGCGCCT -> CCGGCGTAAACCGCGCCTT
ATGCCACTATGATGGCCTT -> TGCCACTATGATGGCCTTG
CGTGTAAGCAGTTCGGTGA -> GTGTAAGCAGTTCGGTGAA
CTCATGCCACGGGCCACAG -> TCATGCCACGGGCCACAGA
TGCCCAGCTTTAACCCTCT -> GCCCAGCTTTAACCCTCTC
AAATCGAGCCGATGGTGTT -> AATCGAGCCGATGGTGTTG
CTAGCAGAATTAGGGACGA -> TAGCAGAATTAGGGACGAG
CTTTTTATAAACAGTAACC -> TTTTTATAAACAGTAACCG
TTAACCCTCTCACTCAGGC -> TAACCCTCTCACTCAGGCA
AGGGAGCCGCGCCTTCCAT -> GGGAGCCGCGCCTTCCATA
GCCGTGTGGTCCGCGCCTT -> CCGTGTGGTCCGCGCCTTC
GATTCGATATGTCTGAGGA -> ATTCGATATGTCTGAGGAT
TCTGCGACTGTTTCACTCA -> CTGCGACTGTTTCACTCAC
CGGTGGGCTAATCGACAAA -> GGTGGGCTAATCGACAAAC
TAACCGGAAATACACAGGC -> AACCGGAAATACACAGGCT
GTGGGGACTTTAGTGCCAG -> TGGGGACTTTAGTGCCAGT
GTGCCTGGAGCTTTTGGCA -> TGCCTGGAGCTTTTGGCAC
GAGCTCTCAACCATACCCG -> AGCTCTCAACCATACCCGT
GTCCTAGGGTTCAAAGGCA -> TCCTAGGGTTCAAAGGCAG
TTTATAAACAGTAACCGGA -> TTATAAACAGTAACCGGAA
GGCACGGCTATTCGTACGT -> GCACGGCTATTCGTACGTG
CACAGGATGACAAAACCAT -> ACAGGATGACAAAACCATC
GCATAACTCTAGTGAGGGC -> CATAACTCTAGTGAGGGCT
CCCTATGCGTGGGGACTTT -> CCTATGCGTGGGGACTTTA
GTCGATTCGATATGTCTGA -> TCGATTCGATATGTCTGAG
GATTACGCCTCTGCGTCTG -> ATTACGCCTCTGCGTCTGG
TGAGTATTTTGCAGGAGCT -> GAGTATTTTGCAGGAGCTC
AGGGACTCTACCAACCCTT -> GGGACTCTACCAACCCTTA
GGGACTTTAGTGCCAGTTG -> GGACTTTAGTGCCAGTTGT
ACGCCACTACGAAGGCCTA -> CGCCACTACGAAGGCCTAT
ACCTAATCCCTATGCGTGG -> CCTAATCCCTATGCGTGGG
CATTATCAGCTCACAAGAA -> ATTATCAGCTCACAAGAAG
CTTCCATATCCCGGCCGCC -> TTCCATATCCCGGCCGCCG
AGTGGTCCGCCTTTATACC -> GTGGTCCGCCTTTATACCA
TGATAGCTCGCGCTAGTGT -> GATAGCTCGCGCTAGTGTC
GTGTTCTCGTATGCGCACG -> TGTTCTCGTATGCGCACGC
TCACAAAAGCGTGTAAGCA -> CACAAAAGCGTGTAAGCAG
TTGATCCGCGCCTTCCATA -> TGATCCGCGCCTTCCATAT
AGAAATCACCCGAGGCCCG -> GAAATCACCCGAGGCCCGT
GGTGACGAATGTCCGTAGA -> GTGACGAATGTCCGTAGAA
GGCTTAACAACGGGAAATA -> GCTTAACAACGGGAAATAC
GGCACCGGCGTAAACCGCG -> GCACCGGCGTAAACCGCGC
CCGAGGCCCGTGCGATCGG -> CGAGGCCCGTGCGATCGGT
CCTGCTGGACCACACGAAG -> CTGCTGGACCACACGAAGT
GGAGCCGCGCCTTCCATAT -> GAGCCGCGCCTTCCATATC
GATGACAAAACCATCGTAG -> ATGACAAAACCATCGTAGA
TGTCTGAGGATGCTCCTAA -> GTCTGAGGATGCTCCTAAA
ACACCTCGTCTGGGTAGTT -> CACCTCGTCTGGGTAGTTC
CGCTTCTACGGTTCTCAGA -> GCTTCTACGGTTCTCAGAC
AGCATAACTGCCCAGCTTT -> GCATAACTGCCCAGCTTTA
TATACCATCACAAAAGCGT -> ATACCATCACAAAAGCGTG
TCCCTATGCGTGGGGACTT -> CCCTATGCGTGGGGACTTT
TTAAAAATCAGTGCGCATA -> TAAAAATCAGTGCGCATAA
GTGGTCCGCGCCTTCCATA -> TGGTCCGCGCCTTCCATAT
GAAGAGTAAATAATTTTGT -> AAGAGTAAATAATTTTGTC
GTGCCCCCTCAGCGCCGGC -> TGCCCCCTCAGCGCCGGCT
ACAGTGTGTTATAATGACG -> CAGTGTGTTATAATGACGA
ATTTTGCAGGAGCTCTCAA -> TTTTGCAGGAGCTCTCAAC
CAGCAGCATTCACGCCTTC -> AGCAGCATTCACGCCTTCG
GAAAACGGACTTACTAATT -> AAAACGGACTTACTAATTC
ATGAGCTCTGCGACTGTTT -> TGAGCTCTGCGACTGTTTC
AGCTCTCAACCATACCCGT -> GCTCTCAACCATACCCGTG
CTGCAACTCCTGGTAGTGG -> TGCAACTCCTGGTAGTGGT
CAGTCGATTCGATATGTCT -> AGTCGATTCGATATGTCTG
GATGGAACCGGTTTCGTCC -> ATGGAACCGGTTTCGTCCG
TTTTTATAAACAGTAACCG -> TTTTATAAACAGTAACCGG
CTCTATATCAGCGCTCTAC -> TCTATATCAGCGCTCTACG
GAAACGGTTGGCCAGCATA -> AAACGGTTGGCCAGCATAA
CGGGTTACATTCTTATGGC -> GGGTTACATTCTTATGGCG
GAGTCTCCAACACTGAACT -> AGTCTCCAACACTGAACTA
TTTACGACCCGCAATTAGA -> TTACGACCCGCAATTAGAG
TGTGGAAATACACAGGCTG -> GTGGAAATACACAGGCTGG
TCACGGACTACGACGCAAT -> CACGGACTACGACGCAATC
ACACTTCTTGAGATTAACA -> CACTTCTTGAGATTAACAG
ATATCAGCGCTCTACGCCA -> TATCAGCGCTCTACGCCAC
TGGCACCGGCGTAAACCGC -> GGCACCGGCGTAAACCGCG
GGCTAGCAGAATTAGGGAC -> GCTAGCAGAATTAGGGACG
ACGCAGATCTAATGGCAGA -> CGCAGATCTAATGGCAGAG
GAAGTGTGTGAAAGAACCG -> AAGTGTGTGAAAGAACCGC
GCAGAATTAGGGACGAGGT -> CAGAATTAGGGACGAGGTT
TAACAACGGGAAATACACA -> AACAACGGGAAATACACAG
CGAGGGAGGGAGCCGCGCC -> GAGGGAGGGAGCCGCGCCT
CTCATTATCAGCTCACAAG -> TCATTATCAGCTCACAAGA
GTACACACCTCGTCTGGGT -> TACACACCTCGTCTGGGTA
CTTCTACGGTTCTCAGACG -> TTCTACGGTTCTCAGACGC
ATGCTAATGGAGTCATGTC -> TGCTAATGGAGTCATGTCT
ACGAAGTGTGTGAAAGAAC -> CGAAGTGTGTGAAAGAACC
AGGAGCTCTCAACCATACC -> GGAGCTCTCAACCATACCC
GGTGATTGCAGGCGCTCGG -> GTGATTGCAGGCGCTCGGA
GATGCTAATGGAGTCATGT -> ATGCTAATGGAGTCATGTC
AATCGACAAACTGTGCTCC -> ATCGACAAACTGTGCTCCA
CCAGGTTACGTTTATCCCG -> CAGGTTACGTTTATCCCGG
AATTTGTGGACCCGCAAAG -> ATTTGTGGACCCGCAAAGT
CAGCGCCGGCTGAGAAGCA -> AGCGCCGGCTGAGAAGCAT
CCGCAATTAGAGTTTACGA -> CGCAATTAGAGTTTACGAA
CCTGTATGTTAAGGTCCAT -> CTGTATGTTAAGGTCCATA
GTAAGAATTAGGTGTATGA -> TAAGAATTAGGTGTATGAA
ACAGTAACCGGAAATACAC -> CAGTAACCGGAAATACACA
TCTCAGACGCTTATGCCGT -> CTCAGACGCTTATGCCGTG
ACAACGGGAAATACACAGG -> CAACGGGAAATACACAGGC
ACAGGCTGGCTAATGCTTG -> CAGGCTGGCTAATGCTTGA
GGGCGTCCCATAACGCGGC -> GGCGTCCCATAACGCGGCA
CACTGAACTATATTTCACG -> ACTGAACTATATTTCACGG
CACGCCTTCGGTCTGCAAC -> ACGCCTTCGGTCTGCAACT
TGAGGGCTAGCGTTATTCC -> GAGGGCTAGCGTTATTCCC
GGTTCAACACACAGATTAC -> GTTCAACACACAGATTACG
AGCGCTCTACGCCACTACG -> GCGCTCTACGCCACTACGA
ATCTGGATCAGCTCGTCGG -> TCTGGATCAGCTCGTCGGT
GCTCCAGTGCCTGGAGCTT -> CTCCAGTGCCTGGAGCTTT
TCCATGCACCGTCCCTGAA -> CCATGCACCGTCCCTGAAA
TTCACTCGTGGTCACAGTG -> TCACTCGTGGTCACAGTGG
CTAATGGAGTCATGTCTCG -> TAATGGAGTCATGTCTCGA
GAGTTAAAAATCAGTGCGC -> AGTTAAAAATCAGTGCGCA
GAGTTTACGAAGCAGCAGG -> AGTTTACGAAGCAGCAGGT
CGATTCGATATGTCTGAGG -> GATTCGATATGTCTGAGGA
CATTTTGGTAGCAACGAAC -> ATTTTGGTAGCAACGAACA
ATCAGTGCGCATAACTCTA -> TCAGTGCGCATAACTCTAG
GGCCCGTGCGATCGGTGGT -> GCCCGTGCGATCGGTGGTC
ATACACAGGCTGGCGAGGG -> TACACAGGCTGGCGAGGGA
GTGGATCTCGCCGTTAAGC -> TGGATCTCGCCGTTAAGCA
TGCAAACCGCAGTGCAAGC -> GCAAACCGCAGTGCAAGCC
AGCCGATGGTGTTGAAAAG -> GCCGATGGTGTTGAAAAGA
TCAAATAACTCATTATCAG -> CAAATAACTCATTATCAGC
GGCGTCCCATAACGCGGCA -> GCGTCCCATAACGCGGCAG
GCATAAAGGCCGAGAGGAA -> CATAAAGGCCGAGAGGAAA
GACTACGACGCAATCTTAT -> ACTACGACGCAATCTTATC
AAGAACCGCTGTGCTGAAA -> AGAACCGCTGTGCTGAAAC
CTCACTCAGGCATTTTGGT -> TCACTCAGGCATTTTGGTA
CAGTAAATGTAAGAATTAG -> AGTAAATGTAAGAATTAGG
AAGTCTGGTATGAGTATTT -> AGTCTGGTATGAGTATTTT
AATGCCACTATGATGGCCT -> ATGCCACTATGATGGCCTT
GCCTTCCATATCCCGGCCG -> CCTTCCATATCCCGGCCGC
AGAATTAGGTGTATGAATC -> GAATTAGGTGTATGAATCT
CCGTGCAAACCGCAGTGCA -> CGTGCAAACCGCAGTGCAA
GTTATAATGACGATAATCA -> TTATAATGACGATAATCAC
GTGTCTCAAATAACTCATT -> TGTCTCAAATAACTCATTA
CTCGGAATTAACTCTCATG -> TCGGAATTAACTCTCATGC
TCCATATCCCGCCTTACGG -> CCATATCCCGCCTTACGGT
GCACGACTCAAGCAAGCCG -> CACGACTCAAGCAAGCCGG
GACAAACTGTGCTCCAGTG -> ACAAACTGTGCTCCAGTGC
ATTCCCTATTGGTGACGTA -> TTCCCTATTGGTGACGTAC
GGTAAACGCAGATCTAATG -> GTAAACGCAGATCTAATGG
CTAAACATGGTTAATGAGA -> TAAACATGGTTAATGAGAT
GCTATTCGTACGTGTACTG -> CTATTCGTACGTGTACTGT
CTCAGGGACTCTACCAACC -> TCAGGGACTCTACCAACCC
CGTACGACGTGAGGTAAGG -> GTACGACGTGAGGTAAGGC
GGATTACCTTTTTATAAAC -> GATTACCTTTTTATAAACA
TACCTTTTTATAAACAGTA -> ACCTTTTTATAAACAGTAA
CCGTACGGAGTCTCCAACA -> CGTACGGAGTCTCCAACAC
TTCGCGGCTTAACAACGGG -> TCGCGGCTTAACAACGGGA
CTTCTTGAGATTAACAGTG -> TTCTTGAGATTAACAGTGT
CGTGTGGTCCGCGCCTTCC -> GTGTGGTCCGCGCCTTCCA
GGCTAATCGACAAACTGTG -> GCTAATCGACAAACTGTGC
TCATGAGTGTCGACCTAAT -> CATGAGTGTCGACCTAATC
CACTATGATGGCCTTGCGC -> ACTATGATGGCCTTGCGCG
ATCAGCTCGTCGGTAAACG -> TCAGCTCGTCGGTAAACGC
TTAACTCTCATGCCACGGG -> TAACTCTCATGCCACGGGC
CTCTCATGCCACGGGCCAC -> TCTCATGCCACGGGCCACA
ATCCCGCCTTACGGTATTC -> TCCCGCCTTACGGTATTCA
TTCCATATCCCGCCTTACG -> TCCATATCCCGCCTTACGG
CCGCCGCCCCTATGTGTCA -> CGCCGCCCCTATGTGTCAA
TCAACCATACCCGTGGACG -> CAACCATACCCGTGGACGT
TGCCTAGGACGAGTAGACT -> GCCTAGGACGAGTAGACTG
TCCCATAACGCGGCAGAAC -> CCCATAACGCGGCAGAACC
CGGAGTCTCCAACACTGAA -> GGAGTCTCCAACACTGAAC
TAACGCGGCAGAACCTCCC -> AACGCGGCAGAACCTCCCC
TGAATCTGGATCAGCTCGT -> GAATCTGGATCAGCTCGTC
TTTGTCGACAGAAATCACC -> TTGTCGACAGAAATCACCC
CCTTCGGTCTGCAACTCCT -> CTTCGGTCTGCAACTCCTG
TGGATCTCGCCGTTAAGCA -> GGATCTCGCCGTTAAGCAC
CCTGGTAGTGGTCCGCCTT -> CTGGTAGTGGTCCGCCTTT
GTGGACGTGCCTAGGACGA -> TGGACGTGCCTAGGACGAG
GCCACAGAAACGGTTGGCC -> CCACAGAAACGGTTGGCCA
GATGGCCTTGCGCGCCAGG -> ATGGCCTTGCGCGCCAGGT
AGATAGAATACAAGGTACG -> GATAGAATACAAGGTACGC
CACACCTCGTCTGGGTAGT -> ACACCTCGTCTGGGTAGTT
TCTGGTATGAGTATTTTGC -> CTGGTATGAGTATTTTGCA
TGGTCCGCCTTTATACCAT -> GGTCCGCCTTTATACCATC
TGGCTAATGCTTGATCCGC -> GGCTAATGCTTGATCCGCG
ACAGAAACGGTTGGCCAGC -> CAGAAACGGTTGGCCAGCA
GGTTTGGTTTACCCGTAGA -> GTTTGGTTTACCCGTAGAG
AGCAGAATTAGGGACGAGG -> GCAGAATTAGGGACGAGGT
AACGTTGATTGGAGACGTC -> ACGTTGATTGGAGACGTCA
CGGCCTCAATCTGACGAAC -> GGCCTCAATCTGACGAACC
GTGAGGGCTAGCGTTATTC -> TGAGGGCTAGCGTTATTCC
TGCTGGACCACACGAAGTG -> GCTGGACCACACGAAGTGT
TATGAGTATTTTGCAGGAG -> ATGAGTATTTTGCAGGAGC
CGCTTGGTAGCTACCGGTG -> GCTTGGTAGCTACCGGTGG
CGAGAGGAAATACACAGGC -> GAGAGGAAATACACAGGCT
GACGATAATCACACAGTCA -> ACGATAATCACACAGTCAG
GGCACACTTCTTGAGATTA -> GCACACTTCTTGAGATTAA
GCGATCGGTGGTCGCTCGG -> CGATCGGTGGTCGCTCGGT
TGGCGTGGATCTCGCCGTT -> GGCGTGGATCTCGCCGTTA
ATCACAAAAGCGTGTAAGC -> TCACAAAAGCGTGTAAGCA
AGACGCTTATGCCGTGCAA -> GACGCTTATGCCGTGCAAA
ATGCCTGCTGGACCACACG -> TGCCTGCTGGACCACACGA
TTACGACCCGCAATTAGAG -> TACGACCCGCAATTAGAGT
AGTACGTATTGTACACACC -> GTACGTATTGTACACACCT
CCGTGGACGTGCCTAGGAC -> CGTGGACGTGCCTAGGACG
GCGTGTAAGCAGTTCGGTG -> CGTGTAAGCAGTTCGGTGA
TGTAAGAATTAGGTGTATG -> GTAAGAATTAGGTGTATGA
GTAGTCCGTACGGAGTCTC -> TAGTCCGTACGGAGTCTCC
ATAATGACGATAATCACAC -> TAATGACGATAATCACACA
ACCCGCAAAGTGTCTCAAA -> CCCGCAAAGTGTCTCAAAT
CGGGTTTGGTCTTTGTTTT -> GGGTTTGGTCTTTGTTTTT
CATACCCGTGGACGTGCCT -> ATACCCGTGGACGTGCCTA
ATGACGATAATCACACAGT -> TGACGATAATCACACAGTC
GCGCCTTCCATATCCCGCA -> CGCCTTCCATATCCCGCAG
GGAATTTGTGGACCCGCAA -> GAATTTGTGGACCCGCAAA
TCTTTGCGTGGATTACCTT -> CTTTGCGTGGATTACCTTT
GAGCTCTGCGACTGTTTCA -> AGCTCTGCGACTGTTTCAC
ATACCCGTGGACGTGCCTA -> TACCCGTGGACGTGCCTAG
GAACCGCTGTGCTGAAACC -> AACCGCTGTGCTGAAACCA
TTCGTCCGCTTCTACGGTT -> TCGTCCGCTTCTACGGTTC
TACATTCTTATGGCGTGGA -> ACATTCTTATGGCGTGGAT
TCGACAAACTGTGCTCCAG -> CGACAAACTGTGCTCCAGT
GAAATCACCCGAGGCCCGT -> AAATCACCCGAGGCCCGTG
TCAACACACAGATTACGCC -> CAACACACAGATTACGCCT
CTTTGCGTGGATTACCTTT -> TTTGCGTGGATTACCTTTT
TCAGCTCGTCGGTAAACGC -> CAGCTCGTCGGTAAACGCA
CGCTAGAAGAGTAAATAAT -> GCTAGAAGAGTAAATAATT
CACGGACTACGACGCAATC -> ACGGACTACGACGCAATCT
AACAACGGGAAATACACAG -> ACAACGGGAAATACACAGG
TGGGGACTTTAGTGCCAGT -> GGGGACTTTAGTGCCAGTT
CGGTGGTCGCTCGGTTTGG -> GGTGGTCGCTCGGTTTGGT
TCACCCGAGGCCCGTGCGA -> CACCCGAGGCCCGTGCGAT
GTAAGCAGTTCGGTGAATG -> TAAGCAGTTCGGTGAATGC
GGCAATGCCTGCTGGACCA -> GCAATGCCTGCTGGACCAC
TGGTTAATGAGATGATAGC -> GGTTAATGAGATGATAGCT
TTATCCCGGGCTGCCATGG -> TATCCCGGGCTGCCATGGG
CTCAGTCTATGCTCAGGGA -> TCAGTCTATGCTCAGGGAC
CAATGCCTGCTGGACCACA -> AATGCCTGCTGGACCACAC
TGAAAAGAGCCGAGTTGAC -> GAAAAGAGCCGAGTTGACC
GATGGTGTTGAAAAGAGCC -> ATGGTGTTGAAAAGAGCCG
CGTGCCTAGGACGAGTAGA -> GTGCCTAGGACGAGTAGAC
GTGTCAAGATGGAACCGGT -> TGTCAAGATGGAACCGGTT
TCTATATCAGCGCTCTACG -> CTATATCAGCGCTCTACGC
AAGCCGGAACTTTGTCGAC -> AGCCGGAACTTTGTCGACA
CTAGCGTTATTCCCTATTG -> TAGCGTTATTCCCTATTGG
GTAGAACGTTGATTGGAGA -> TAGAACGTTGATTGGAGAC
ACTACGAAGGCCTATCGAC -> CTACGAAGGCCTATCGACT
CCATATGTGGAAGTCTGGT -> CATATGTGGAAGTCTGGTA
GAGACGTCACCGGTAGCGG -> AGACGTCACCGGTAGCGGG
CTAAGAGAGATAGAATACA -> TAAGAGAGATAGAATACAA
GTCATGTCTCGATCGTCGG -> TCATGTCTCGATCGTCGGT
ATCGTCGGTAGTCCGTACG -> TCGTCGGTAGTCCGTACGG
ATTGGCGTCCTAGGGTTCA -> TTGGCGTCCTAGGGTTCAA
CTACGACGCAATCTTATCC -> TACGACGCAATCTTATCCG
ATCCCGCTAGAAGAGTAAA -> TCCCGCTAGAAGAGTAAAT
TCTCATGCCACGGGCCACA -> CTCATGCCACGGGCCACAG
CGTAGAACGTTGATTGGAG -> GTAGAACGTTGATTGGAGA
CGTGGATCTCGCCGTTAAG -> GTGGATCTCGCCGTTAAGC
TGTGTTATAATGACGATAA -> GTGTTATAATGACGATAAT
AGGCAATGCCTGCTGGACC -> GGCAATGCCTGCTGGACCA
ACGGGCCACAGAAACGGTT -> CGGGCCACAGAAACGGTTG
AAAGCGTGTAAGCAGTTCG -> AAGCGTGTAAGCAGTTCGG
GCAGCATTCACGCCTTCGG -> CAGCATTCACGCCTTCGGT
TGCGGGCGTCCCATAACGC -> GCGGGCGTCCCATAACGCG
CGGTTGGCCAGCATAAAGG -> GGTTGGCCAGCATAAAGGC
AGGGACGAGGTTCAACACA -> GGGACGAGGTTCAACACAC
GTTTACCCGTAGAGGCACG -> TTTACCCGTAGAGGCACGG
AGTGGAGGTGGCTGAGAAA -> GTGGAGGTGGCTGAGAAAC
GCCCCCTCAGCGCCGGCTG -> CCCCCTCAGCGCCGGCTGA
ACCGCGCCTTCCATATCCC -> CCGCGCCTTCCATATCCCG
AGGTACGCACACTCAGTCG -> GGTACGCACACTCAGTCGA
AACCTCCCCGTTTTCGCAT -> ACCTCCCCGTTTTCGCATA
TAGCAGAATTAGGGACGAG -> AGCAGAATTAGGGACGAGG
GAACGTTGATTGGAGACGT -> AACGTTGATTGGAGACGTC
TTCTTATGGCGTGGATCTC -> TCTTATGGCGTGGATCTCG
TCACACAGTCAGAGGCTAG -> CACACAGTCAGAGGCTAGC
CGGAACTTTGTCGACAGAA -> GGAACTTTGTCGACAGAAA
TTAAGGTCCATATGTGGAA -> TAAGGTCCATATGTGGAAG
TCACTCGTGGTCACAGTGG -> CACTCGTGGTCACAGTGGT
ACAAACTGTGCTCCAGTGC -> CAAACTGTGCTCCAGTGCC
ATGGTTAATGAGATGATAG -> TGGTTAATGAGATGATAGC
ATTACCTTTTTATAAACAG -> TTACCTTTTTATAAACAGT
ACGCTTATGCCGTGCAAAC -> CGCTTATGCCGTGCAAACC
GGAGCTTTTGGCACACTTC -> GAGCTTTTGGCACACTTCT
CTGAGAAACTGTGTTCTCG -> TGAGAAACTGTGTTCTCGT
CCGTAGAGGCACGGCTATT -> CGTAGAGGCACGGCTATTC
ACTGTGTTCTCGTATGCGC -> CTGTGTTCTCGTATGCGCA
CGGGAATTTGTGGACCCGC -> GGGAATTTGTGGACCCGCA
ACTAATTCCGGTCGGTCTT -> CTAATTCCGGTCGGTCTTT
CACACAGATTACGCCTCTG -> ACACAGATTACGCCTCTGC
GTGTCGAGCGATGAGCTCT -> TGTCGAGCGATGAGCTCTG
GTCTTTGTTTTTTTCGCGG -> TCTTTGTTTTTTTCGCGGC
CTTTAGTGCCAGTTGTTTA -> TTTAGTGCCAGTTGTTTAC
TTAGGTGTATGAATCTGGA -> TAGGTGTATGAATCTGGAT
AAATCAGTGCGCATAACTC -> AATCAGTGCGCATAACTCT
GGCTGGCGAGGGAGGGAGC -> GCTGGCGAGGGAGGGAGCC
CTGGAGCTTTTGGCACACT -> TGGAGCTTTTGGCACACTT
GACCTAATCCCTATGCGTG -> ACCTAATCCCTATGCGTGG
GTAAATAATTTTGTCGATT -> TAAATAATTTTGTCGATTC
TGCGTCTGGCCTGTATGTT -> GCGTCTGGCCTGTATGTTA
GCTACCGGTGGGCTAATCG -> CTACCGGTGGGCTAATCGA
GCTAGTGTCCCCGTGTCGA -> CTAGTGTCCCCGTGTCGAG
GGTGGCTGAGAAACTGTGT -> GTGGCTGAGAAACTGTGTT
GCCTTGCGCGCCAGGTTAC -> CCTTGCGCGCCAGGTTACG
TGTCGGCGTCGGAAGTGGA -> GTCGGCGTCGGAAGTGGAG
TGGACCACACGAAGTGTGT -> GGACCACACGAAGTGTGTG
ACATGCGGGAATTTGTGGA -> CATGCGGGAATTTGTGGAC
CATAACTCTAGTGAGGGCT -> ATAACTCTAGTGAGGGCTA
TCCCGCCTTACGGTATTCA -> CCCGCCTTACGGTATTCAC
GTCGGAAGTGGAGGTGGCT -> TCGGAAGTGGAGGTGGCTG
TTCTCGTATGCGCACGCAG -> TCTCGTATGCGCACGCAGC
GGGCTGCCATGGGAAAATC -> GGCTGCCATGGGAAAATCG
TAATCGACAAACTGTGCTC -> AATCGACAAACTGTGCTCC
ACGGCCTCAATCTGACGAA -> CGGCCTCAATCTGACGAAC
GTGATTGCAGGCGCTCGGA -> TGATTGCAGGCGCTCGGAA
TTATCAGCTCACAAGAAGC -> TATCAGCTCACAAGAAGCT
TACGGTTCTCAGACGCTTA -> ACGGTTCTCAGACGCTTAT
AAGGTACGCACACTCAGTC -> AGGTACGCACACTCAGTCG
CCTCCCCGTTTTCGCATAT -> CTCCCCGTTTTCGCATATT
GTGGTCACAGTGGTGACGA -> TGGTCACAGTGGTGACGAA
CACCTCGTCTGGGTAGTTC -> ACCTCGTCTGGGTAGTTCT
GAACTATATTTCACGGACT -> AACTATATTTCACGGACTA
ATCGAGCCGATGGTGTTGA -> TCGAGCCGATGGTGTTGAA
AATCCCTATGCGTGGGGAC -> ATCCCTATGCGTGGGGACT
GAATCTGGATCAGCTCGTC -> AATCTGGATCAGCTCGTCG
GCCCCTATGTGTCAAGATG -> CCCCTATGTGTCAAGATGG
GCCGCCCCTATGTGTCAAG -> CCGCCCCTATGTGTCAAGA
TGAAATTAAGCATTCTCTA -> GAAATTAAGCATTCTCTAT
GGTATTCACTCGTGGTCAC -> GTATTCACTCGTGGTCACA
ACTATGATGGCCTTGCGCG -> CTATGATGGCCTTGCGCGC
GAAAATCGAGCCGATGGTG -> AAAATCGAGCCGATGGTGT
AACATGGTTAATGAGATGA -> ACATGGTTAATGAGATGAT
GAGGGAGCCGCGCCTTCCA -> AGGGAGCCGCGCCTTCCAT
CCAGCATAAAGGCCGAGAG -> CAGCATAAAGGCCGAGAGG
AAACTGTGTTCTCGTATGC -> AACTGTGTTCTCGTATGCG
TACGACGCAATCTTATCCG -> ACGACGCAATCTTATCCGC
GATTGCAGGCGCTCGGAAT -> ATTGCAGGCGCTCGGAATT
GGATCTCGCCGTTAAGCAC -> GATCTCGCCGTTAAGCACC
CCCGCAAAGTGTCTCAAAT -> CCGCAAAGTGTCTCAAATA
GTGCGATCGGTGGTCGCTC -> TGCGATCGGTGGTCGCTCG
ATTGGTGACGTACGACGTG -> TTGGTGACGTACGACGTGA
GCGCCTTCCATATCCCGGC -> CGCCTTCCATATCCCGGCC
GCGTCGGAAGTGGAGGTGG -> CGTCGGAAGTGGAGGTGGC
GACGTACGACGTGAGGTAA -> ACGTACGACGTGAGGTAAG
CGTCTGGCCTGTATGTTAA -> GTCTGGCCTGTATGTTAAG
GGTTACGTTTATCCCGGGC -> GTTACGTTTATCCCGGGCT
CAGGATGACAAAACCATCG -> AGGATGACAAAACCATCGT
CGTGCGATCGGTGGTCGCT -> GTGCGATCGGTGGTCGCTC
TGTGGACCCGCAAAGTGTC -> GTGGACCCGCAAAGTGTCT
TCTCGCCGTTAAGCACCAT -> CTCGCCGTTAAGCACCATC
TCACTCAGGCATTTTGGTA -> CACTCAGGCATTTTGGTAG
AGGAAATACACAGGCTGGC -> GGAAATACACAGGCTGGCA
CACAGGCTGTGGAAATACA -> ACAGGCTGTGGAAATACAC
CTCTATGATGCTAATGGAG -> TCTATGATGCTAATGGAGT
TCGGTAAACGCAGATCTAA -> CGGTAAACGCAGATCTAAT
CATATCCCGCAGTGACGAA -> ATATCCCGCAGTGACGAAT
TTTACCCGTAGAGGCACGG -> TTACCCGTAGAGGCACGGC
GCGCTCGGAATTAACTCTC -> CGCTCGGAATTAACTCTCA
CTTACGGAGTTAAAAATCA -> TTACGGAGTTAAAAATCAG
GCAACTCCTGGTAGTGGTC -> CAACTCCTGGTAGTGGTCC
ACACGAAGTGTGTGAAAGA -> CACGAAGTGTGTGAAAGAA
CAAGCCGGAACTTTGTCGA -> AAGCCGGAACTTTGTCGAC
TACGGAGTCTCCAACACTG -> ACGGAGTCTCCAACACTGA
CGGTGAATGCCACTATGAT -> GGTGAATGCCACTATGATG
TCACCGGTAGCGGGTTTGG -> CACCGGTAGCGGGTTTGGT
AGAGAGATAGAATACAAGG -> GAGAGATAGAATACAAGGT
GTGCCAGTTGTTTACGACC -> TGCCAGTTGTTTACGACCC
AACACTGAACTATATTTCA -> ACACTGAACTATATTTCAC
TGTCTCGATCGTCGGTAGT -> GTCTCGATCGTCGGTAGTC
CAGCTCACAAGAAGCTGAA -> AGCTCACAAGAAGCTGAAA
CCATCACAAAAGCGTGTAA -> CATCACAAAAGCGTGTAAG
GCTCCTAAACATGGTTAAT -> CTCCTAAACATGGTTAATG
GAGGGAGGGAGCCGCGCCT -> AGGGAGGGAGCCGCGCCTT
GCCACGGGCCACAGAAACG -> CCACGGGCCACAGAAACGG
AAGGCCGAGAGGAAATACA -> AGGCCGAGAGGAAATACAC
GTCCGCCTTTATACCATCA -> TCCGCCTTTATACCATCAC
CGTCCCATAACGCGGCAGA -> GTCCCATAACGCGGCAGAA
GGATGACAAAACCATCGTA -> GATGACAAAACCATCGTAG
AAATAACTCATTATCAGCT -> AATAACTCATTATCAGCTC
ACTCACTCTATATCAGCGC -> CTCACTCTATATCAGCGCT
TTGGCGTCCTAGGGTTCAA -> TGGCGTCCTAGGGTTCAAA
TACCATCACAAAAGCGTGT -> ACCATCACAAAAGCGTGTA
CTGCGTCTGGCCTGTATGT -> TGCGTCTGGCCTGTATGTT
CCCATAACGCGGCAGAACC -> CCATAACGCGGCAGAACCT
GTGGTCGCTCGGTTTGGTT -> TGGTCGCTCGGTTTGGTTT
CATCATGAGTGTCGACCTA -> ATCATGAGTGTCGACCTAA
TAACTCTAGTGAGGGCTAG -> AACTCTAGTGAGGGCTAGC
TTAGGGACGAGGTTCAACA -> TAGGGACGAGGTTCAACAC
TATGCTCAGGGACTCTACC -> ATGCTCAGGGACTCTACCA
TCGCGGCTTAACAACGGGA -> CGCGGCTTAACAACGGGAA
TAGCTACCGGTGGGCTAAT -> AGCTACCGGTGGGCTAATC
GACGAATGTCCGTAGAAGC -> ACGAATGTCCGTAGAAGCG
GAAATACACAGGCTGTGGA -> AAATACACAGGCTGTGGAA
GATAGCTCGCGCTAGTGTC -> ATAGCTCGCGCTAGTGTCC
CAATCTTATCCGCCGCCCC -> AATCTTATCCGCCGCCCCT
GTCTATGCTCAGGGACTCT -> TCTATGCTCAGGGACTCTA
TAGAACGTTGATTGGAGAC -> AGAACGTTGATTGGAGACG
TGGAGCTTTTGGCACACTT -> GGAGCTTTTGGCACACTTC
CGACAGAAATCACCCGAGG -> GACAGAAATCACCCGAGGC
CCTAAACATGGTTAATGAG -> CTAAACATGGTTAATGAGA
CCATATCCCGCCTTACGGT -> CATATCCCGCCTTACGGTA
TGTATGAATCTGGATCAGC -> GTATGAATCTGGATCAGCT
CACACAGTCAGAGGCTAGC -> ACACAGTCAGAGGCTAGCA
TAGAAGCGGTGCGGGTTAC -> AGAAGCGGTGCGGGTTACA
CGACGTGAGGTAAGGCAAT -> GACGTGAGGTAAGGCAATG
TTCACGGACTACGACGCAA -> TCACGGACTACGACGCAAT
GCCCAGCTTTAACCCTCTC -> CCCAGCTTTAACCCTCTCA
GTGGAGGTGGCTGAGAAAC -> TGGAGGTGGCTGAGAAACT
CCTAATCCCTATGCGTGGG -> CTAATCCCTATGCGTGGGG
ACTCCACCCAGTTCCTGCA -> CTCCACCCAGTTCCTGCAC
GCGCCGGCTGAGAAGCATA -> CGCCGGCTGAGAAGCATAA
ATGCTAAGAGAGATAGAAT -> TGCTAAGAGAGATAGAATA
AGAAGAGTAAATAATTTTG -> GAAGAGTAAATAATTTTGT
AGCTGAAATTAAGCATTCT -> GCTGAAATTAAGCATTCTC
TAATCCCTATGCGTGGGGA -> AATCCCTATGCGTGGGGAC
GAGCGATGAGCTCTGCGAC -> AGCGATGAGCTCTGCGACT
TCACAAGAAGCTGAAATTA -> CACAAGAAGCTGAAATTAA
ATTTGTGGACCCGCAAAGT -> TTTGTGGACCCGCAAAGTG
AGTGACGAATAGTACGTAT -> GTGACGAATAGTACGTATT
TGGGAAAATCGAGCCGATG -> GGGAAAATCGAGCCGATGG
GTTTGGTTTACCCGTAGAG -> TTTGGTTTACCCGTAGAGG
GCGGGTTACATTCTTATGG -> CGGGTTACATTCTTATGGC
TCTGAGGATGCTCCTAAAC -> CTGAGGATGCTCCTAAACA
AATACACAGGCTGTGGAAA -> ATACACAGGCTGTGGAAAT
CGGAGTTAAAAATCAGTGC -> GGAGTTAAAAATCAGTGCG
ATATGTCTGAGGATGCTCC -> TATGTCTGAGGATGCTCCT
ACCCATCAAAACATGCGGG -> CCCATCAAAACATGCGGGA
GCCTTCCATATCCCGCAGT -> CCTTCCATATCCCGCAGTG
GGCTATTCGTACGTGTACT -> GCTATTCGTACGTGTACTG
CTGCACGACTCAAGCAAGC -> TGCACGACTCAAGCAAGCC
CACTCAGTCGATTCGATAT -> ACTCAGTCGATTCGATATG
AAACGGACTTACTAATTCC -> AACGGACTTACTAATTCCG
GTGTACTGTCGGCGTCGGA -> TGTACTGTCGGCGTCGGAA
GGTGCGGGTTACATTCTTA -> GTGCGGGTTACATTCTTAT
TAAAGGCCGAGAGGAAATA -> AAAGGCCGAGAGGAAATAC
CTGCGGGCGTCCCATAACG -> TGCGGGCGTCCCATAACGC
CTAATCCCTATGCGTGGGG -> TAATCCCTATGCGTGGGGA
AATTAGAGTTTACGAAGCA -> ATTAGAGTTTACGAAGCAG
CCTGGAGCTTTTGGCACAC -> CTGGAGCTTTTGGCACACT
TGCGACTGTTTCACTCACT -> GCGACTGTTTCACTCACTC
TGGATCAGCTCGTCGGTAA -> GGATCAGCTCGTCGGTAAA
GAAGCGGTGCGGGTTACAT -> AAGCGGTGCGGGTTACATT
AGCCGCGCCTTCCATATCC -> GCCGCGCCTTCCATATCCC
TCCCGGGCTGCCATGGGAA -> CCCGGGCTGCCATGGGAAA
TAAACAGTAACCGGAAATA -> AAACAGTAACCGGAAATAC
CGGCGTCGGAAGTGGAGGT -> GGCGTCGGAAGTGGAGGTG
GTCCGTACGGAGTCTCCAA -> TCCGTACGGAGTCTCCAAC
ATTATCAGCTCACAAGAAG -> TTATCAGCTCACAAGAAGC
GTAGTGGTCCGCCTTTATA -> TAGTGGTCCGCCTTTATAC
CCATATCCCGGCCGCCGTG -> CATATCCCGGCCGCCGTGT
GTGTGTGAAAGAACCGCTG -> TGTGTGAAAGAACCGCTGT
TCCCTATTGGTGACGTACG -> CCCTATTGGTGACGTACGA
GGGCTAATCGACAAACTGT -> GGCTAATCGACAAACTGTG
TAATGACGATAATCACACA -> AATGACGATAATCACACAG
CGCCTTACGGTATTCACTC -> GCCTTACGGTATTCACTCG
ACATGCTAAGAGAGATAGA -> CATGCTAAGAGAGATAGAA
CTCCCATCTCAGTCTATGC -> TCCCATCTCAGTCTATGCT
CACCCAGTTCCTGCACGAC -> ACCCAGTTCCTGCACGACT
TGACCACAGGATGACAAAA -> GACCACAGGATGACAAAAC
CGCGCCAGGTTACGTTTAT -> GCGCCAGGTTACGTTTATC
ATTAACAGTGTGTTATAAT -> TTAACAGTGTGTTATAATG
CATTCACGCCTTCGGTCTG -> ATTCACGCCTTCGGTCTGC
ACTGCGGGCGTCCCATAAC -> CTGCGGGCGTCCCATAACG
GCTTGGTAGCTACCGGTGG -> CTTGGTAGCTACCGGTGGG
ACGAGTAGACTGTATACGG -> CGAGTAGACTGTATACGGC
GCCGTTAAGCACCATCATG -> CCGTTAAGCACCATCATGA
TACCAACCCTTACGGAGTT -> ACCAACCCTTACGGAGTTA
GTCCCTGAAATTGGCGTCC -> TCCCTGAAATTGGCGTCCT
GTGAGGTAAGGCAATGCCT -> TGAGGTAAGGCAATGCCTG
CTATGATGCTAATGGAGTC -> TATGATGCTAATGGAGTCA
TGACGAATAGTACGTATTG -> GACGAATAGTACGTATTGT
CTTTTGGCACACTTCTTGA -> TTTTGGCACACTTCTTGAG
CCCTGAAATTGGCGTCCTA -> CCTGAAATTGGCGTCCTAG
GACGAATAGTACGTATTGT -> ACGAATAGTACGTATTGTA
TCTGGATCAGCTCGTCGGT -> CTGGATCAGCTCGTCGGTA
GCTGAGAAGCATAACTGCC -> CTGAGAAGCATAACTGCCC
AGGAAAACGGACTTACTAA -> GGAAAACGGACTTACTAAT
CTAATGGCAGAGAGGTGCC -> TAATGGCAGAGAGGTGCCC
AAAAGAGCCGAGTTGACCA -> AAAGAGCCGAGTTGACCAC
CACACGAAGTGTGTGAAAG -> ACACGAAGTGTGTGAAAGA
CGGGCGTCCCATAACGCGG -> GGGCGTCCCATAACGCGGC
ATTACGCCTCTGCGTCTGG -> TTACGCCTCTGCGTCTGGC
GGCTAATGCTTGATCCGCG -> GCTAATGCTTGATCCGCGC
GCGTTATTCCCTATTGGTG -> CGTTATTCCCTATTGGTGA
TTTGGCACACTTCTTGAGA -> TTGGCACACTTCTTGAGAT
GGTTTCGTCCGCTTCTACG -> GTTTCGTCCGCTTCTACGG
GAGGTGATTGCAGGCGCTC -> AGGTGATTGCAGGCGCTCG
ACGTGCCTAGGACGAGTAG -> CGTGCCTAGGACGAGTAGA
CGGTTTGGTTTACCCGTAG -> GGTTTGGTTTACCCGTAGA
TCAAGATGGAACCGGTTTC -> CAAGATGGAACCGGTTTCG
GCAGGCGCTCGGAATTAAC -> CAGGCGCTCGGAATTAACT
AAGCAAGCCGGAACTTTGT -> AGCAAGCCGGAACTTTGTC
GACTGCGGGCGTCCCATAA -> ACTGCGGGCGTCCCATAAC
GGAGTTAAAAATCAGTGCG -> GAGTTAAAAATCAGTGCGC
AGCTCGTCGGTAAACGCAG -> GCTCGTCGGTAAACGCAGA
AATAATTTTGTCGATTCCA -> ATAATTTTGTCGATTCCAT
AGGTAAGGCAATGCCTGCT -> GGTAAGGCAATGCCTGCTG
GCTCTACGCCACTACGAAG -> CTCTACGCCACTACGAAGG
AGCAGCAGGTCGCTTGGTA -> GCAGCAGGTCGCTTGGTAG
GCGAGGTGATTGCAGGCGC -> CGAGGTGATTGCAGGCGCT
GAAGGCCTATCGACTTCGA -> AAGGCCTATCGACTTCGAG
GTGCTGAAACCAAAGTTGA -> TGCTGAAACCAAAGTTGAC
CGTAGAGGCACGGCTATTC -> GTAGAGGCACGGCTATTCG
AACCCATCAAAACATGCGG -> ACCCATCAAAACATGCGGG
AAAGTGTCTCAAATAACTC -> AAGTGTCTCAAATAACTCA
TCTCCAACACTGAACTATA -> CTCCAACACTGAACTATAT
GGCGTAAACCGCGCCTTCC -> GCGTAAACCGCGCCTTCCA
AATGCTTGATCCGCGCCTT -> ATGCTTGATCCGCGCCTTC
CGTGGTCACAGTGGTGACG -> GTGGTCACAGTGGTGACGA
TATCAGCGCTCTACGCCAC -> ATCAGCGCTCTACGCCACT
CACTCTATATCAGCGCTCT -> ACTCTATATCAGCGCTCTA
ATGATGGCCTTGCGCGCCA -> TGATGGCCTTGCGCGCCAG
TGGCAGAGAGGTGCCCCCT -> GGCAGAGAGGTGCCCCCTC
ACGGGAAATACACAGGCTG -> CGGGAAATACACAGGCTGG
AACTGCCCAGCTTTAACCC -> ACTGCCCAGCTTTAACCCT
CAGAGGCTAGCAGAATTAG -> AGAGGCTAGCAGAATTAGG
ATCAGCTCACAAGAAGCTG -> TCAGCTCACAAGAAGCTGA
CGTTATTCCCTATTGGTGA -> GTTATTCCCTATTGGTGAC
AAGGTCCATATGTGGAAGT -> AGGTCCATATGTGGAAGTC
TACGACGTGAGGTAAGGCA -> ACGACGTGAGGTAAGGCAA
AGATTAACAGTGTGTTATA -> GATTAACAGTGTGTTATAA
TTTCACGGACTACGACGCA -> TTCACGGACTACGACGCAA
CAGAACCTCCCCGTTTTCG -> AGAACCTCCCCGTTTTCGC
GCGTGGATTACCTTTTTAT -> CGTGGATTACCTTTTTATA
AATGGCAGAGAGGTGCCCC -> ATGGCAGAGAGGTGCCCCC
AAAGAACCGCTGTGCTGAA -> AAGAACCGCTGTGCTGAAA
AAGCATTCTCTATGATGCT -> AGCATTCTCTATGATGCTA
TAGGACGAGTAGACTGTAT -> AGGACGAGTAGACTGTATA
GTATGTTAAGGTCCATATG -> TATGTTAAGGTCCATATGT
GTGTGTTATAATGACGATA -> TGTGTTATAATGACGATAA
AAACATGCGGGAATTTGTG -> AACATGCGGGAATTTGTGG
CGAACATGCTAAGAGAGAT -> GAACATGCTAAGAGAGATA
AGGACGAGTAGACTGTATA -> GGACGAGTAGACTGTATAC
GACGTGAGGTAAGGCAATG -> ACGTGAGGTAAGGCAATGC
GTTTACGAAGCAGCAGGTC -> TTTACGAAGCAGCAGGTCG
GCCGGAACTTTGTCGACAG -> CCGGAACTTTGTCGACAGA
TTCGATATGTCTGAGGATG -> TCGATATGTCTGAGGATGC
ACACAGTCAGAGGCTAGCA -> CACAGTCAGAGGCTAGCAG
TGAGAAACTGTGTTCTCGT -> GAGAAACTGTGTTCTCGTA
GTTTCGTCCGCTTCTACGG -> TTTCGTCCGCTTCTACGGT
AGCATTCACGCCTTCGGTC -> GCATTCACGCCTTCGGTCT
AAAACATGCGGGAATTTGT -> AAACATGCGGGAATTTGTG
TTAAGCACCATCATGAGTG -> TAAGCACCATCATGAGTGT
ATGCCGTGCAAACCGCAGT -> TGCCGTGCAAACCGCAGTG
TGCGATCGGTGGTCGCTCG -> GCGATCGGTGGTCGCTCGG
GTATTGTACACACCTCGTC -> TATTGTACACACCTCGTCT
ACGAAGCAGCAGGTCGCTT -> CGAAGCAGCAGGTCGCTTG
AGGGCTAGCGTTATTCCCT -> GGGCTAGCGTTATTCCCTA
CAGTGCAAGCCCCGAGGAA -> AGTGCAAGCCCCGAGGAAA
AACTCCTGGTAGTGGTCCG -> ACTCCTGGTAGTGGTCCGC
ACCGGAAATACACAGGCTG -> CCGGAAATACACAGGCTGT
TGCGCACGCAGCAGCATTC -> GCGCACGCAGCAGCATTCA
GCCTTTATACCATCACAAA -> CCTTTATACCATCACAAAA
GTGGCTGAGAAACTGTGTT -> TGGCTGAGAAACTGTGTTC
GTTGAAAAGAGCCGAGTTG -> TTGAAAAGAGCCGAGTTGA
CGCCAGGTTACGTTTATCC -> GCCAGGTTACGTTTATCCC
GAAATACACAGGCTGGCTA -> AAATACACAGGCTGGCTAA
GCGTCTGGCCTGTATGTTA -> CGTCTGGCCTGTATGTTAA
AAATACACAGGCTGGCGAG -> AATACACAGGCTGGCGAGG
ATGGGAAAATCGAGCCGAT -> TGGGAAAATCGAGCCGATG
TCAAAGGCAGTAAATGTAA -> CAAAGGCAGTAAATGTAAG
TATCCGCCGCCCCTATGTG -> ATCCGCCGCCCCTATGTGT
GTGTCGACCTAATCCCTAT -> TGTCGACCTAATCCCTATG
TGCTCAGGGACTCTACCAA -> GCTCAGGGACTCTACCAAC
TGGTAGCAACGAACATGCT -> GGTAGCAACGAACATGCTA
CCACTATGATGGCCTTGCG -> CACTATGATGGCCTTGCGC
CAGTTCGGTGAATGCCACT -> AGTTCGGTGAATGCCACTA
TGCTCCAGTGCCTGGAGCT -> GCTCCAGTGCCTGGAGCTT
CACTCAGGCATTTTGGTAG -> ACTCAGGCATTTTGGTAGC
GGTACGCACACTCAGTCGA -> GTACGCACACTCAGTCGAT
AAGAGAGATAGAATACAAG -> AGAGAGATAGAATACAAGG
TCATGCCACGGGCCACAGA -> CATGCCACGGGCCACAGAA
TTACGGAGTTAAAAATCAG -> TACGGAGTTAAAAATCAGT
TGCCTGCTGGACCACACGA -> GCCTGCTGGACCACACGAA
AATGTAAGAATTAGGTGTA -> ATGTAAGAATTAGGTGTAT
TGGTAGTGGTCCGCCTTTA -> GGTAGTGGTCCGCCTTTAT
CTGTGCTCCAGTGCCTGGA -> TGTGCTCCAGTGCCTGGAG
ACCATCACAAAAGCGTGTA -> CCATCACAAAAGCGTGTAA
GTATGCGCACGCAGCAGCA -> TATGCGCACGCAGCAGCAT
GCCGAGAGGAAATACACAG -> CCGAGAGGAAATACACAGG
TGTCTCAAATAACTCATTA -> GTCTCAAATAACTCATTAT
TCTTGAGATTAACAGTGTG -> CTTGAGATTAACAGTGTGT
TATCCCGCTAGAAGAGTAA -> ATCCCGCTAGAAGAGTAAA
AGGCTGGCACCGGCGTAAA -> GGCTGGCACCGGCGTAAAC
CGCTTATGCCGTGCAAACC -> GCTTATGCCGTGCAAACCG
TTTTGGCACACTTCTTGAG -> TTTGGCACACTTCTTGAGA
CTGGATCAGCTCGTCGGTA -> TGGATCAGCTCGTCGGTAA
CCCGCCTTACGGTATTCAC -> CCGCCTTACGGTATTCACT
GAGGATGCTCCTAAACATG -> AGGATGCTCCTAAACATGG
ACTCAGTCGATTCGATATG -> CTCAGTCGATTCGATATGT
GAGGAAATACACAGGCTGG -> AGGAAATACACAGGCTGGC
ATCAAAACATGCGGGAATT -> TCAAAACATGCGGGAATTT
CTCCACCCAGTTCCTGCAC -> TCCACCCAGTTCCTGCACG
TTCACGCCTTCGGTCTGCA -> TCACGCCTTCGGTCTGCAA
AGTGCAAGCCCCGAGGAAA -> GTGCAAGCCCCGAGGAAAA
TGTGCTGAAACCAAAGTTG -> GTGCTGAAACCAAAGTTGA
GCTCGGAATTAACTCTCAT -> CTCGGAATTAACTCTCATG
CCGTGTGGTCCGCGCCTTC -> CGTGTGGTCCGCGCCTTCC
AAAGTTGACTGCGGGCGTC -> AAGTTGACTGCGGGCGTCC
CGAAGTGTGTGAAAGAACC -> GAAGTGTGTGAAAGAACCG
GCAGTAAATGTAAGAATTA -> CAGTAAATGTAAGAATTAG
ACTCTAGTGAGGGCTAGCG -> CTCTAGTGAGGGCTAGCGT
TTTGTCGATTCCATGCACC -> TTGTCGATTCCATGCACCG
GCAGGAGCTCTCAACCATA -> CAGGAGCTCTCAACCATAC
ATCCCGCAGTGACGAATAG -> TCCCGCAGTGACGAATAGT
GGTCGCTTGGTAGCTACCG -> GTCGCTTGGTAGCTACCGG
AGAAGCATAACTGCCCAGC -> GAAGCATAACTGCCCAGCT
TTCCATATCCCGCAGTGAC -> TCCATATCCCGCAGTGACG
CTGAACTATATTTCACGGA -> TGAACTATATTTCACGGAC
GCTTTTGGCACACTTCTTG -> CTTTTGGCACACTTCTTGA
CGCGCCTTCCATATCCCGC -> GCGCCTTCCATATCCCGCA, GCGCCTTCCATATCCCGCT, GCGCCTTCCATATCCCGCC
GGGAGCCGCGCCTTCCATA -> GGAGCCGCGCCTTCCATAT
AGCTTTTGGCACACTTCTT -> GCTTTTGGCACACTTCTTG
GCCGTGCAAACCGCAGTGC -> CCGTGCAAACCGCAGTGCA
GGTCCGCGCCTTCCATATC -> GTCCGCGCCTTCCATATCC
AGTTGACCACAGGATGACA -> GTTGACCACAGGATGACAA
CTGTATACGGCCTCAATCT -> TGTATACGGCCTCAATCTG
GCCAGGTTACGTTTATCCC -> CCAGGTTACGTTTATCCCG
CCTTCCATATCCCGCCTTA -> CTTCCATATCCCGCCTTAC
GAATTAACTCTCATGCCAC -> AATTAACTCTCATGCCACG
TTAGAGTTTACGAAGCAGC -> TAGAGTTTACGAAGCAGCA
TTTGTGGACCCGCAAAGTG -> TTGTGGACCCGCAAAGTGT
TGAGTGTCGACCTAATCCC -> GAGTGTCGACCTAATCCCT
GATTGGAGACGTCACCGGT -> ATTGGAGACGTCACCGGTA
TAACCCTCTCACTCAGGCA -> AACCCTCTCACTCAGGCAT
TATGTCTGAGGATGCTCCT -> ATGTCTGAGGATGCTCCTA
AACCGGAAATACACAGGCT -> ACCGGAAATACACAGGCTG
AACTGTGTTCTCGTATGCG -> ACTGTGTTCTCGTATGCGC
CTGGACCACACGAAGTGTG -> TGGACCACACGAAGTGTGT
AACGGACTTACTAATTCCG -> ACGGACTTACTAATTCCGG
CCAACACTGAACTATATTT -> CAACACTGAACTATATTTC
AATAGTACGTATTGTACAC -> ATAGTACGTATTGTACACA
ACTCGTGGTCACAGTGGTG -> CTCGTGGTCACAGTGGTGA
ATGCTCCTAAACATGGTTA -> TGCTCCTAAACATGGTTAA
GAGTTGACCACAGGATGAC -> AGTTGACCACAGGATGACA
AGCGTTATTCCCTATTGGT -> GCGTTATTCCCTATTGGTG
AGAAGCTGAAATTAAGCAT -> GAAGCTGAAATTAAGCATT
ACGGAGTCTCCAACACTGA -> CGGAGTCTCCAACACTGAA
TGATTGCAGGCGCTCGGAA -> GATTGCAGGCGCTCGGAAT
TATTGGTGACGTACGACGT -> ATTGGTGACGTACGACGTG
GAACATGCTAAGAGAGATA -> AACATGCTAAGAGAGATAG
AGAGTTTACGAAGCAGCAG -> GAGTTTACGAAGCAGCAGG
TTAACAGTGTGTTATAATG -> TAACAGTGTGTTATAATGA
GAGAGGAAATACACAGGCT -> AGAGGAAATACACAGGCTG
AAATACACAGGCTGGCACC -> AATACACAGGCTGGCACCG
CGGACTACGACGCAATCTT -> GGACTACGACGCAATCTTA
GATTACCTTTTTATAAACA -> ATTACCTTTTTATAAACAG
GCCTTACGGTATTCACTCG -> CCTTACGGTATTCACTCGT
GGATCAGCTCGTCGGTAAA -> GATCAGCTCGTCGGTAAAC
TGCTAATGGAGTCATGTCT -> GCTAATGGAGTCATGTCTC
GTTCCTGCACGACTCAAGC -> TTCCTGCACGACTCAAGCA
GGAGGTGGCTGAGAAACTG -> GAGGTGGCTGAGAAACTGT
ACACTCAGTCGATTCGATA -> CACTCAGTCGATTCGATAT
AAGTGTCTCAAATAACTCA -> AGTGTCTCAAATAACTCAT
CATGCACCGTCCCTGAAAT -> ATGCACCGTCCCTGAAATT
TCGAGCGATGAGCTCTGCG -> CGAGCGATGAGCTCTGCGA
CCGTGCGATCGGTGGTCGC -> CGTGCGATCGGTGGTCGCT
TTGACTGCGGGCGTCCCAT -> TGACTGCGGGCGTCCCATA
CAGCAGGTCGCTTGGTAGC -> AGCAGGTCGCTTGGTAGCT
GATAGAATACAAGGTACGC -> ATAGAATACAAGGTACGCA
GAGGCTAGCAGAATTAGGG -> AGGCTAGCAGAATTAGGGA
ACGCAATCTTATCCGCCGC -> CGCAATCTTATCCGCCGCC
CTAGAAGAGTAAATAATTT -> TAGAAGAGTAAATAATTTT
ATTAGAGTTTACGAAGCAG -> TTAGAGTTTACGAAGCAGC
CCCTCAGCGCCGGCTGAGA -> CCTCAGCGCCGGCTGAGAA
GGAGGGAGCCGCGCCTTCC -> GAGGGAGCCGCGCCTTCCA
GTCTGAGGATGCTCCTAAA -> TCTGAGGATGCTCCTAAAC
TTGGTGACGTACGACGTGA -> TGGTGACGTACGACGTGAG
CACAAGAAGCTGAAATTAA -> ACAAGAAGCTGAAATTAAG
TTGGTAGCAACGAACATGC -> TGGTAGCAACGAACATGCT
CTTACTAATTCCGGTCGGT -> TTACTAATTCCGGTCGGTC
TGGGTAGTTCTCCCATCTC -> GGGTAGTTCTCCCATCTCA
AGGCAGTAAATGTAAGAAT -> GGCAGTAAATGTAAGAATT
GGTGAATGCCACTATGATG -> GTGAATGCCACTATGATGG
TAGTACGTATTGTACACAC -> AGTACGTATTGTACACACC
CGCGCCTTCCATATCCCGG -> GCGCCTTCCATATCCCGGC
GTGACGAATAGTACGTATT -> TGACGAATAGTACGTATTG
ATCTAATGGCAGAGAGGTG -> TCTAATGGCAGAGAGGTGC
AAACCGCAGTGCAAGCCCC -> AACCGCAGTGCAAGCCCCG
GAGTGTCGACCTAATCCCT -> AGTGTCGACCTAATCCCTA
GTCGACCTAATCCCTATGC -> TCGACCTAATCCCTATGCG
ATAACTCATTATCAGCTCA -> TAACTCATTATCAGCTCAC
CAGCGCTCTACGCCACTAC -> AGCGCTCTACGCCACTACG
CCAGTGCCTGGAGCTTTTG -> CAGTGCCTGGAGCTTTTGG
AAAGGCAGTAAATGTAAGA -> AAGGCAGTAAATGTAAGAA
AAAAATCAGTGCGCATAAC -> AAAATCAGTGCGCATAACT
CACGACTCAAGCAAGCCGG -> ACGACTCAAGCAAGCCGGA
ATACACAGGCTGGCACCGG -> TACACAGGCTGGCACCGGC
CTTATGGCGTGGATCTCGC -> TTATGGCGTGGATCTCGCC
GTGGATTACCTTTTTATAA -> TGGATTACCTTTTTATAAA
GACCACACGAAGTGTGTGA -> ACCACACGAAGTGTGTGAA
TTTGTTTTTTTCGCGGCTT -> TTGTTTTTTTCGCGGCTTA
TTGTCGACAGAAATCACCC -> TGTCGACAGAAATCACCCG
ACTACGACGCAATCTTATC -> CTACGACGCAATCTTATCC
TTCGTACGTGTACTGTCGG -> TCGTACGTGTACTGTCGGC
AGGTGATTGCAGGCGCTCG -> GGTGATTGCAGGCGCTCGG
TCATGTCTCGATCGTCGGT -> CATGTCTCGATCGTCGGTA
GAAAGAACCGCTGTGCTGA -> AAAGAACCGCTGTGCTGAA
TGCGCATAACTCTAGTGAG -> GCGCATAACTCTAGTGAGG
AGCATTCTCTATGATGCTA -> GCATTCTCTATGATGCTAA
TTTAACCCTCTCACTCAGG -> TTAACCCTCTCACTCAGGC
TGGTGACGTACGACGTGAG -> GGTGACGTACGACGTGAGG
TCCATATCCCGGCCGCCGT -> CCATATCCCGGCCGCCGTG
AGGCGCTCGGAATTAACTC -> GGCGCTCGGAATTAACTCT
GCCCGTGCGATCGGTGGTC -> CCCGTGCGATCGGTGGTCG
CAACTCCTGGTAGTGGTCC -> AACTCCTGGTAGTGGTCCG
CATGAGTGTCGACCTAATC -> ATGAGTGTCGACCTAATCC
AGGGTTCAAAGGCAGTAAA -> GGGTTCAAAGGCAGTAAAT
TTCCCTATTGGTGACGTAC -> TCCCTATTGGTGACGTACG
AACGCAGATCTAATGGCAG -> ACGCAGATCTAATGGCAGA
TCCGTAGAAGCGGTGCGGG -> CCGTAGAAGCGGTGCGGGT
AGTCTATGCTCAGGGACTC -> GTCTATGCTCAGGGACTCT
CTCAGACGCTTATGCCGTG -> TCAGACGCTTATGCCGTGC
CGGCTATTCGTACGTGTAC -> GGCTATTCGTACGTGTACT
CTCGTCTGGGTAGTTCTCC -> TCGTCTGGGTAGTTCTCCC
ATGTCCGTAGAAGCGGTGC -> TGTCCGTAGAAGCGGTGCG
TTACGCCTCTGCGTCTGGC -> TACGCCTCTGCGTCTGGCC
ATTCACTCGTGGTCACAGT -> TTCACTCGTGGTCACAGTG
TGTAAGCAGTTCGGTGAAT -> GTAAGCAGTTCGGTGAATG
ACAGGCTGGCACCGGCGTA -> CAGGCTGGCACCGGCGTAA
CACTTCTTGAGATTAACAG -> ACTTCTTGAGATTAACAGT
CAAAGTGTCTCAAATAACT -> AAAGTGTCTCAAATAACTC
CTCTAGTGAGGGCTAGCGT -> TCTAGTGAGGGCTAGCGTT
GGAGCTCTCAACCATACCC -> GAGCTCTCAACCATACCCG
CATATGTGGAAGTCTGGTA -> ATATGTGGAAGTCTGGTAT
ATGCGTGGGGACTTTAGTG -> TGCGTGGGGACTTTAGTGC
TGGAACCGGTTTCGTCCGC -> GGAACCGGTTTCGTCCGCT
TGAATGCCACTATGATGGC -> GAATGCCACTATGATGGCC
GGACCCGCAAAGTGTCTCA -> GACCCGCAAAGTGTCTCAA
TATTTCACGGACTACGACG -> ATTTCACGGACTACGACGC
TACGTGTACTGTCGGCGTC -> ACGTGTACTGTCGGCGTCG
TTCCATATCCCGGCCGCCG -> TCCATATCCCGGCCGCCGT
TATGAATCTGGATCAGCTC -> ATGAATCTGGATCAGCTCG
CAAACTGTGCTCCAGTGCC -> AAACTGTGCTCCAGTGCCT
CTCAGCGCCGGCTGAGAAG -> TCAGCGCCGGCTGAGAAGC
CGATGGTGTTGAAAAGAGC -> GATGGTGTTGAAAAGAGCC
ATACGGCCTCAATCTGACG -> TACGGCCTCAATCTGACGA
TCTTATGGCGTGGATCTCG -> CTTATGGCGTGGATCTCGC
CTTATGCCGTGCAAACCGC -> TTATGCCGTGCAAACCGCA
TTTGGTAGCAACGAACATG -> TTGGTAGCAACGAACATGC
TAAGCATTCTCTATGATGC -> AAGCATTCTCTATGATGCT
TGGCTGAGAAACTGTGTTC -> GGCTGAGAAACTGTGTTCT
GTGCAAACCGCAGTGCAAG -> TGCAAACCGCAGTGCAAGC
ATGTCTCGATCGTCGGTAG -> TGTCTCGATCGTCGGTAGT
AACCAAAGTTGACTGCGGG -> ACCAAAGTTGACTGCGGGC
GGTCTGCAACTCCTGGTAG -> GTCTGCAACTCCTGGTAGT
CGGCAGAACCTCCCCGTTT -> GGCAGAACCTCCCCGTTTT
GTAGCGGGTTTGGTCTTTG -> TAGCGGGTTTGGTCTTTGT
CGCTCGGTTTGGTTTACCC -> GCTCGGTTTGGTTTACCCG
GTACGTGTACTGTCGGCGT -> TACGTGTACTGTCGGCGTC
GCAGTGACGAATAGTACGT -> CAGTGACGAATAGTACGTA
GATTCCATGCACCGTCCCT -> ATTCCATGCACCGTCCCTG
ATTGCAGGCGCTCGGAATT -> TTGCAGGCGCTCGGAATTA
ATCACACAGTCAGAGGCTA -> TCACACAGTCAGAGGCTAG
GCCAGCATAAAGGCCGAGA -> CCAGCATAAAGGCCGAGAG
GAGCCGCGCCTTCCATATC -> AGCCGCGCCTTCCATATCC
TAAATGTAAGAATTAGGTG -> AAATGTAAGAATTAGGTGT
GTCTCGATCGTCGGTAGTC -> TCTCGATCGTCGGTAGTCC
CCTATGCGTGGGGACTTTA -> CTATGCGTGGGGACTTTAG
GCGCATAACTCTAGTGAGG -> CGCATAACTCTAGTGAGGG
AACGGTTGGCCAGCATAAA -> ACGGTTGGCCAGCATAAAG
GCAGAACCTCCCCGTTTTC -> CAGAACCTCCCCGTTTTCG
GGACTTTAGTGCCAGTTGT -> GACTTTAGTGCCAGTTGTT
TGGACCCGCAAAGTGTCTC -> GGACCCGCAAAGTGTCTCA
AGTATTTTGCAGGAGCTCT -> GTATTTTGCAGGAGCTCTC
CGCCTTCGGTCTGCAACTC -> GCCTTCGGTCTGCAACTCC
TCCAACACTGAACTATATT -> CCAACACTGAACTATATTT
CGCCTTCCATATCCCGCAG -> GCCTTCCATATCCCGCAGT
CGTCGGTAGTCCGTACGGA -> GTCGGTAGTCCGTACGGAG
GACGCAATCTTATCCGCCG -> ACGCAATCTTATCCGCCGC
CTCTCAACCATACCCGTGG -> TCTCAACCATACCCGTGGA
GGAACCGGTTTCGTCCGCT -> GAACCGGTTTCGTCCGCTT
GTGAATGCCACTATGATGG -> TGAATGCCACTATGATGGC
AATACACAGGCTGGCTAAT -> ATACACAGGCTGGCTAATG
ACACAGGCTGGCACCGGCG -> CACAGGCTGGCACCGGCGT
CAAGCCCCGAGGAAAACGG -> AAGCCCCGAGGAAAACGGA
TGTTTACGACCCGCAATTA -> GTTTACGACCCGCAATTAG
GTAAGGCAATGCCTGCTGG -> TAAGGCAATGCCTGCTGGA
TTTTGGTAGCAACGAACAT -> TTTGGTAGCAACGAACATG
GAGGCACGGCTATTCGTAC -> AGGCACGGCTATTCGTACG
GTCGGCGTCGGAAGTGGAG -> TCGGCGTCGGAAGTGGAGG
AAGTGTGTGAAAGAACCGC -> AGTGTGTGAAAGAACCGCT
TAGCGGGTTTGGTCTTTGT -> AGCGGGTTTGGTCTTTGTT
AGGTTACGTTTATCCCGGG -> GGTTACGTTTATCCCGGGC
AGGCCCGTGCGATCGGTGG -> GGCCCGTGCGATCGGTGGT
AACTCTCATGCCACGGGCC -> ACTCTCATGCCACGGGCCA
CGGCGTAAACCGCGCCTTC -> GGCGTAAACCGCGCCTTCC
CCAACCCTTACGGAGTTAA -> CAACCCTTACGGAGTTAAA
CACAGTCAGAGGCTAGCAG -> ACAGTCAGAGGCTAGCAGA
GAGAGGTGCCCCCTCAGCG -> AGAGGTGCCCCCTCAGCGC
ACTATATTTCACGGACTAC -> CTATATTTCACGGACTACG
TACACAGGCTGGCTAATGC -> ACACAGGCTGGCTAATGCT
TCTCGTATGCGCACGCAGC -> CTCGTATGCGCACGCAGCA
GGCCAGCATAAAGGCCGAG -> GCCAGCATAAAGGCCGAGA
TAGTGTCCCCGTGTCGAGC -> AGTGTCCCCGTGTCGAGCG
CCGGTTTCGTCCGCTTCTA -> CGGTTTCGTCCGCTTCTAC
AACATGCTAAGAGAGATAG -> ACATGCTAAGAGAGATAGA
AAAGAGCCGAGTTGACCAC -> AAGAGCCGAGTTGACCACA
TAAGGTCCATATGTGGAAG -> AAGGTCCATATGTGGAAGT
CTCCAGTGCCTGGAGCTTT -> TCCAGTGCCTGGAGCTTTT
ACACACCTCGTCTGGGTAG -> CACACCTCGTCTGGGTAGT
GTTGATTGGAGACGTCACC -> TTGATTGGAGACGTCACCG
GCGTCCCATAACGCGGCAG -> CGTCCCATAACGCGGCAGA
GTCTGGGTAGTTCTCCCAT -> TCTGGGTAGTTCTCCCATC
GGACCACACGAAGTGTGTG -> GACCACACGAAGTGTGTGA
TAACAGTGTGTTATAATGA -> AACAGTGTGTTATAATGAC
AAGTGGAGGTGGCTGAGAA -> AGTGGAGGTGGCTGAGAAA
CACGGCTATTCGTACGTGT -> ACGGCTATTCGTACGTGTA
GCCGAGTTGACCACAGGAT -> CCGAGTTGACCACAGGATG
CTAATGCTTGATCCGCGCC -> TAATGCTTGATCCGCGCCT
ACGGACTACGACGCAATCT -> CGGACTACGACGCAATCTT
GTAGCAACGAACATGCTAA -> TAGCAACGAACATGCTAAG
CCTCAGCGCCGGCTGAGAA -> CTCAGCGCCGGCTGAGAAG
CGGTCTTTGCGTGGATTAC -> GGTCTTTGCGTGGATTACC
GGGCTAGCGTTATTCCCTA -> GGCTAGCGTTATTCCCTAT
AGGATGCTCCTAAACATGG -> GGATGCTCCTAAACATGGT
ATGCTCAGGGACTCTACCA -> TGCTCAGGGACTCTACCAA
GTTATTCCCTATTGGTGAC -> TTATTCCCTATTGGTGACG
TTGTTTTTTTCGCGGCTTA -> TGTTTTTTTCGCGGCTTAA
GATCGGTGGTCGCTCGGTT -> ATCGGTGGTCGCTCGGTTT
GGTTCTCAGACGCTTATGC -> GTTCTCAGACGCTTATGCC
TCTGCGTCTGGCCTGTATG -> CTGCGTCTGGCCTGTATGT
GCACGGCTATTCGTACGTG -> CACGGCTATTCGTACGTGT
TCGTCGGTAAACGCAGATC -> CGTCGGTAAACGCAGATCT
ACCGCAGTGCAAGCCCCGA -> CCGCAGTGCAAGCCCCGAG
TGCAGGAGCTCTCAACCAT -> GCAGGAGCTCTCAACCATA
GGTTTGGTCTTTGTTTTTT -> GTTTGGTCTTTGTTTTTTT
CTGGGTAGTTCTCCCATCT -> TGGGTAGTTCTCCCATCTC
ATGTCTGAGGATGCTCCTA -> TGTCTGAGGATGCTCCTAA
TATCAGCTCACAAGAAGCT -> ATCAGCTCACAAGAAGCTG
CACCCGAGGCCCGTGCGAT -> ACCCGAGGCCCGTGCGATC
AAGGCAGTAAATGTAAGAA -> AGGCAGTAAATGTAAGAAT
TGCCACGGGCCACAGAAAC -> GCCACGGGCCACAGAAACG
CGAGCGATGAGCTCTGCGA -> GAGCGATGAGCTCTGCGAC
CTGGCACCGGCGTAAACCG -> TGGCACCGGCGTAAACCGC
CTACCAACCCTTACGGAGT -> TACCAACCCTTACGGAGTT
TAGCGTTATTCCCTATTGG -> AGCGTTATTCCCTATTGGT
CCGGCTGAGAAGCATAACT -> CGGCTGAGAAGCATAACTG
GGCCTGTATGTTAAGGTCC -> GCCTGTATGTTAAGGTCCA
GGTCGGTCTTTGCGTGGAT -> GTCGGTCTTTGCGTGGATT
GCAGCAGGTCGCTTGGTAG -> CAGCAGGTCGCTTGGTAGC
CGTATGCGCACGCAGCAGC -> GTATGCGCACGCAGCAGCA
GGTGACGTACGACGTGAGG -> GTGACGTACGACGTGAGGT
ACCCGTAGAGGCACGGCTA -> CCCGTAGAGGCACGGCTAT
GCTGGACCACACGAAGTGT -> CTGGACCACACGAAGTGTG
ATTGTACACACCTCGTCTG -> TTGTACACACCTCGTCTGG
TATGCCGTGCAAACCGCAG -> ATGCCGTGCAAACCGCAGT
GTGGAAGTCTGGTATGAGT -> TGGAAGTCTGGTATGAGTA
TTACATTCTTATGGCGTGG -> TACATTCTTATGGCGTGGA
TCGCTTGGTAGCTACCGGT -> CGCTTGGTAGCTACCGGTG
AGGCTGGCGAGGGAGGGAG -> GGCTGGCGAGGGAGGGAGC
TCCCGCAGTGACGAATAGT -> CCCGCAGTGACGAATAGTA
CTCTGCGTCTGGCCTGTAT -> TCTGCGTCTGGCCTGTATG
GAATACAAGGTACGCACAC -> AATACAAGGTACGCACACT
ATCTCAGTCTATGCTCAGG -> TCTCAGTCTATGCTCAGGG
CAGTTCCTGCACGACTCAA -> AGTTCCTGCACGACTCAAG
ACCGGTTTCGTCCGCTTCT -> CCGGTTTCGTCCGCTTCTA
GTGTGGTCCGCGCCTTCCA -> TGTGGTCCGCGCCTTCCAT
TGGTCACAGTGGTGACGAA -> GGTCACAGTGGTGACGAAT
CGCCTTCCATATCCCGGCC -> GCCTTCCATATCCCGGCCG
GTGCGGGTTACATTCTTAT -> TGCGGGTTACATTCTTATG
CCACAGGATGACAAAACCA -> CACAGGATGACAAAACCAT
TCTAATGGCAGAGAGGTGC -> CTAATGGCAGAGAGGTGCC
TTACGTTTATCCCGGGCTG -> TACGTTTATCCCGGGCTGC
GAACCTCCCCGTTTTCGCA -> AACCTCCCCGTTTTCGCAT
GTCGGTAAACGCAGATCTA -> TCGGTAAACGCAGATCTAA
ATGGTGTTGAAAAGAGCCG -> TGGTGTTGAAAAGAGCCGA
GACTGTATACGGCCTCAAT -> ACTGTATACGGCCTCAATC
AGGGAGGGAGCCGCGCCTT -> GGGAGGGAGCCGCGCCTTC
AGGTGCCCCCTCAGCGCCG -> GGTGCCCCCTCAGCGCCGG
GGACGAGGTTCAACACACA -> GACGAGGTTCAACACACAG
CGCTCGGAATTAACTCTCA -> GCTCGGAATTAACTCTCAT
GTTCTCCCATCTCAGTCTA -> TTCTCCCATCTCAGTCTAT
ACGTACGACGTGAGGTAAG -> CGTACGACGTGAGGTAAGG
AGTGTGTTATAATGACGAT -> GTGTGTTATAATGACGATA
AACTCTAGTGAGGGCTAGC -> ACTCTAGTGAGGGCTAGCG
AATGCCTGCTGGACCACAC -> ATGCCTGCTGGACCACACG
TCCGCCTTTATACCATCAC -> CCGCCTTTATACCATCACA
CCCAGTTCCTGCACGACTC -> CCAGTTCCTGCACGACTCA
ATTCCATGCACCGTCCCTG -> TTCCATGCACCGTCCCTGA
AGCCGGAACTTTGTCGACA -> GCCGGAACTTTGTCGACAG
TTCCATATCCCGCTAGAAG -> TCCATATCCCGCTAGAAGA
GCCTCAATCTGACGAACCC -> CCTCAATCTGACGAACCCA
AACCCTTACGGAGTTAAAA -> ACCCTTACGGAGTTAAAAA
TCTCAGTCTATGCTCAGGG -> CTCAGTCTATGCTCAGGGA
TTCCATGCACCGTCCCTGA -> TCCATGCACCGTCCCTGAA
GCGTGGGGACTTTAGTGCC -> CGTGGGGACTTTAGTGCCA
TATTGTACACACCTCGTCT -> ATTGTACACACCTCGTCTG
GTTGACTGCGGGCGTCCCA -> TTGACTGCGGGCGTCCCAT
CCTATCGACTTCGAGAACT -> CTATCGACTTCGAGAACTC
GCCTTCCATATCCCGCCTT -> CCTTCCATATCCCGCCTTA
TCTACCAACCCTTACGGAG -> CTACCAACCCTTACGGAGT
GAGCTTTTGGCACACTTCT -> AGCTTTTGGCACACTTCTT
TCAGTCTATGCTCAGGGAC -> CAGTCTATGCTCAGGGACT
TCAGCGCCGGCTGAGAAGC -> CAGCGCCGGCTGAGAAGCA
CTCCAACACTGAACTATAT -> TCCAACACTGAACTATATT
TCGTGGTCACAGTGGTGAC -> CGTGGTCACAGTGGTGACG
CAGTGCGCATAACTCTAGT -> AGTGCGCATAACTCTAGTG
CGCAATTAGAGTTTACGAA -> GCAATTAGAGTTTACGAAG
GCTGAAACCAAAGTTGACT -> CTGAAACCAAAGTTGACTG
GGTTAATGAGATGATAGCT -> GTTAATGAGATGATAGCTC
AAACAGTAACCGGAAATAC -> AACAGTAACCGGAAATACA
GGAAGTCTGGTATGAGTAT -> GAAGTCTGGTATGAGTATT
TGAGGATGCTCCTAAACAT -> GAGGATGCTCCTAAACATG
CTTCCATATCCCGCAGTGA -> TTCCATATCCCGCAGTGAC
TCCCCGTGTCGAGCGATGA -> CCCCGTGTCGAGCGATGAG
GCTCTGCGACTGTTTCACT -> CTCTGCGACTGTTTCACTC
TCTCACTCAGGCATTTTGG -> CTCACTCAGGCATTTTGGT
TGCGTGGATTACCTTTTTA -> GCGTGGATTACCTTTTTAT
TGCCACTATGATGGCCTTG -> GCCACTATGATGGCCTTGC
CCGGTGGGCTAATCGACAA -> CGGTGGGCTAATCGACAAA
AGATGGAACCGGTTTCGTC -> GATGGAACCGGTTTCGTCC
GTTGGCCAGCATAAAGGCC -> TTGGCCAGCATAAAGGCCG
GGTTGGCCAGCATAAAGGC -> GTTGGCCAGCATAAAGGCC
AGGTCGCTTGGTAGCTACC -> GGTCGCTTGGTAGCTACCG
TTTACGAAGCAGCAGGTCG -> TTACGAAGCAGCAGGTCGC
TCTACGGTTCTCAGACGCT -> CTACGGTTCTCAGACGCTT
ATCGACTTCGAGAACTCCA -> TCGACTTCGAGAACTCCAC
TCAGGCATTTTGGTAGCAA -> CAGGCATTTTGGTAGCAAC
AGCGTGTAAGCAGTTCGGT -> GCGTGTAAGCAGTTCGGTG
AGCACCATCATGAGTGTCG -> GCACCATCATGAGTGTCGA
TCTCTATGATGCTAATGGA -> CTCTATGATGCTAATGGAG
ATAGAATACAAGGTACGCA -> TAGAATACAAGGTACGCAC
CTTCCATATCCCGCCTTAC -> TTCCATATCCCGCCTTACG
CGCAGTGACGAATAGTACG -> GCAGTGACGAATAGTACGT
ACAGGATGACAAAACCATC -> CAGGATGACAAAACCATCG
CTTAACAACGGGAAATACA -> TTAACAACGGGAAATACAC
GGTTACATTCTTATGGCGT -> GTTACATTCTTATGGCGTG
AACTCCACCCAGTTCCTGC -> ACTCCACCCAGTTCCTGCA
ATAACGCGGCAGAACCTCC -> TAACGCGGCAGAACCTCCC
GGAGTCTCCAACACTGAAC -> GAGTCTCCAACACTGAACT
CAGCATAAAGGCCGAGAGG -> AGCATAAAGGCCGAGAGGA
GCTGAGAAACTGTGTTCTC -> CTGAGAAACTGTGTTCTCG
GTCCGCGCCTTCCATATCC -> TCCGCGCCTTCCATATCCC
CTGACGAACCCATCAAAAC -> TGACGAACCCATCAAAACA
AGGCCGAGAGGAAATACAC -> GGCCGAGAGGAAATACACA
CCATATCCCGCTAGAAGAG -> CATATCCCGCTAGAAGAGT
TAAGAATTAGGTGTATGAA -> AAGAATTAGGTGTATGAAT
TCTCAACCATACCCGTGGA -> CTCAACCATACCCGTGGAC
TCAGAGGCTAGCAGAATTA -> CAGAGGCTAGCAGAATTAG
AAAAGCGTGTAAGCAGTTC -> AAAGCGTGTAAGCAGTTCG
TTGTGGACCCGCAAAGTGT -> TGTGGACCCGCAAAGTGTC
CAACCATACCCGTGGACGT -> AACCATACCCGTGGACGTG
TACGCCACTACGAAGGCCT -> ACGCCACTACGAAGGCCTA
GCACGCAGCAGCATTCACG -> CACGCAGCAGCATTCACGC
AATACACAGGCTGGCACCG -> ATACACAGGCTGGCACCGG
AGTAAATGTAAGAATTAGG -> GTAAATGTAAGAATTAGGT
ACTCATTATCAGCTCACAA -> CTCATTATCAGCTCACAAG
GATTAACAGTGTGTTATAA -> ATTAACAGTGTGTTATAAT
GCATTTTGGTAGCAACGAA -> CATTTTGGTAGCAACGAAC
AAGGCAATGCCTGCTGGAC -> AGGCAATGCCTGCTGGACC
GCATTCACGCCTTCGGTCT -> CATTCACGCCTTCGGTCTG
GCAACGAACATGCTAAGAG -> CAACGAACATGCTAAGAGA
GTGCAAGCCCCGAGGAAAA -> TGCAAGCCCCGAGGAAAAC
TGGCGAGGGAGGGAGCCGC -> GGCGAGGGAGGGAGCCGCG
AGCATAAAGGCCGAGAGGA -> GCATAAAGGCCGAGAGGAA
CAAAAGCGTGTAAGCAGTT -> AAAAGCGTGTAAGCAGTTC
GCCTTCCATATCCCGCTAG -> CCTTCCATATCCCGCTAGA
TTGGCCAGCATAAAGGCCG -> TGGCCAGCATAAAGGCCGA
ACCATACCCGTGGACGTGC -> CCATACCCGTGGACGTGCC
TCGTATGCGCACGCAGCAG -> CGTATGCGCACGCAGCAGC
CGCAGATCTAATGGCAGAG -> GCAGATCTAATGGCAGAGA
GGTCCGCCTTTATACCATC -> GTCCGCCTTTATACCATCA
ATGCTTGATCCGCGCCTTC -> TGCTTGATCCGCGCCTTCC
ACGAACCCATCAAAACATG -> CGAACCCATCAAAACATGC
CCGCAGTGCAAGCCCCGAG -> CGCAGTGCAAGCCCCGAGG
GGTGTTGAAAAGAGCCGAG -> GTGTTGAAAAGAGCCGAGT
CAATTAGAGTTTACGAAGC -> AATTAGAGTTTACGAAGCA
CCGCCTTACGGTATTCACT -> CGCCTTACGGTATTCACTC
TGCCCCCTCAGCGCCGGCT -> GCCCCCTCAGCGCCGGCTG
AGAGGAAATACACAGGCTG -> GAGGAAATACACAGGCTGG
CAAGCAAGCCGGAACTTTG -> AAGCAAGCCGGAACTTTGT
GGCAGAACCTCCCCGTTTT -> GCAGAACCTCCCCGTTTTC
CTCGCCGTTAAGCACCATC -> TCGCCGTTAAGCACCATCA
CGGCCGCCGTGTGGTCCGC -> GGCCGCCGTGTGGTCCGCG
GGTGGTCGCTCGGTTTGGT -> GTGGTCGCTCGGTTTGGTT
ACGTATTGTACACACCTCG -> CGTATTGTACACACCTCGT
ACCGGTAGCGGGTTTGGTC -> CCGGTAGCGGGTTTGGTCT
AATCGAGCCGATGGTGTTG -> ATCGAGCCGATGGTGTTGA
CCGGCGTAAACCGCGCCTT -> CGGCGTAAACCGCGCCTTC
AGAGAGGTGCCCCCTCAGC -> GAGAGGTGCCCCCTCAGCG
AGTAACCGGAAATACACAG -> GTAACCGGAAATACACAGG
TGGTCGCTCGGTTTGGTTT -> GGTCGCTCGGTTTGGTTTA
TTGGCACACTTCTTGAGAT -> TGGCACACTTCTTGAGATT
TTTATCCCGGGCTGCCATG -> TTATCCCGGGCTGCCATGG
CCCGGCCGCCGTGTGGTCC -> CCGGCCGCCGTGTGGTCCG
GCTAGCGTTATTCCCTATT -> CTAGCGTTATTCCCTATTG
TAGCAACGAACATGCTAAG -> AGCAACGAACATGCTAAGA
GAAGCAGCAGGTCGCTTGG -> AAGCAGCAGGTCGCTTGGT
TATATTTCACGGACTACGA -> ATATTTCACGGACTACGAC
GGTCCATATGTGGAAGTCT -> GTCCATATGTGGAAGTCTG
GGCAGTAAATGTAAGAATT -> GCAGTAAATGTAAGAATTA
TGTCGACCTAATCCCTATG -> GTCGACCTAATCCCTATGC
CACAGAAACGGTTGGCCAG -> ACAGAAACGGTTGGCCAGC
GTTAAAAATCAGTGCGCAT -> TTAAAAATCAGTGCGCATA
ACGCCTCTGCGTCTGGCCT -> CGCCTCTGCGTCTGGCCTG
CGCCACTACGAAGGCCTAT -> GCCACTACGAAGGCCTATC
CGAGAACTCCACCCAGTTC -> GAGAACTCCACCCAGTTCC
CGACCCGCAATTAGAGTTT -> GACCCGCAATTAGAGTTTA
ACAGATTACGCCTCTGCGT -> CAGATTACGCCTCTGCGTC
TAGAATACAAGGTACGCAC -> AGAATACAAGGTACGCACA
CTCAGGCATTTTGGTAGCA -> TCAGGCATTTTGGTAGCAA
GCAGAGAGGTGCCCCCTCA -> CAGAGAGGTGCCCCCTCAG
GTTTATCCCGGGCTGCCAT -> TTTATCCCGGGCTGCCATG
CTCGATCGTCGGTAGTCCG -> TCGATCGTCGGTAGTCCGT
AAATACACAGGCTGTGGAA -> AATACACAGGCTGTGGAAA
GTCCGCTTCTACGGTTCTC -> TCCGCTTCTACGGTTCTCA
GGCTGAGAAGCATAACTGC -> GCTGAGAAGCATAACTGCC
ACACAGGCTGGCGAGGGAG -> CACAGGCTGGCGAGGGAGG
GATCTCGCCGTTAAGCACC -> ATCTCGCCGTTAAGCACCA
TATTCGTACGTGTACTGTC -> ATTCGTACGTGTACTGTCG
GAGGGCTAGCGTTATTCCC -> AGGGCTAGCGTTATTCCCT
CCATAACGCGGCAGAACCT -> CATAACGCGGCAGAACCTC
TGAACTATATTTCACGGAC -> GAACTATATTTCACGGACT
AACGCGGCAGAACCTCCCC -> ACGCGGCAGAACCTCCCCG
CCATACCCGTGGACGTGCC -> CATACCCGTGGACGTGCCT
GGACTTACTAATTCCGGTC -> GACTTACTAATTCCGGTCG
GGGAAAATCGAGCCGATGG -> GGAAAATCGAGCCGATGGT
GTGGTCCGCCTTTATACCA -> TGGTCCGCCTTTATACCAT
CGCGCTAGTGTCCCCGTGT -> GCGCTAGTGTCCCCGTGTC
CTTTATACCATCACAAAAG -> TTTATACCATCACAAAAGC
ACTCAAGCAAGCCGGAACT -> CTCAAGCAAGCCGGAACTT
TGTGTTCTCGTATGCGCAC -> GTGTTCTCGTATGCGCACG
ATAAACAGTAACCGGAAAT -> TAAACAGTAACCGGAAATA
CACGAAGTGTGTGAAAGAA -> ACGAAGTGTGTGAAAGAAC
TCAATCTGACGAACCCATC -> CAATCTGACGAACCCATCA
TTGGAGACGTCACCGGTAG -> TGGAGACGTCACCGGTAGC
TGAGGTAAGGCAATGCCTG -> GAGGTAAGGCAATGCCTGC
ACTGAACTATATTTCACGG -> CTGAACTATATTTCACGGA
ATGGAGTCATGTCTCGATC -> TGGAGTCATGTCTCGATCG
ACAAAAGCGTGTAAGCAGT -> CAAAAGCGTGTAAGCAGTT
ATTCCGGTCGGTCTTTGCG -> TTCCGGTCGGTCTTTGCGT
CTCAATCTGACGAACCCAT -> TCAATCTGACGAACCCATC
CGGTTTCGTCCGCTTCTAC -> GGTTTCGTCCGCTTCTACG
GCCAGTTGTTTACGACCCG -> CCAGTTGTTTACGACCCGC
ACACAGATTACGCCTCTGC -> CACAGATTACGCCTCTGCG
GCTCTCAACCATACCCGTG -> CTCTCAACCATACCCGTGG
ACCAAAGTTGACTGCGGGC -> CCAAAGTTGACTGCGGGCG
AGGCTAGCAGAATTAGGGA -> GGCTAGCAGAATTAGGGAC
GTAAATGTAAGAATTAGGT -> TAAATGTAAGAATTAGGTG
CTAATCGACAAACTGTGCT -> TAATCGACAAACTGTGCTC
CGTGGACGTGCCTAGGACG -> GTGGACGTGCCTAGGACGA
TGGAGACGTCACCGGTAGC -> GGAGACGTCACCGGTAGCG
ATGGAACCGGTTTCGTCCG -> TGGAACCGGTTTCGTCCGC
TGCTTGATCCGCGCCTTCC -> GCTTGATCCGCGCCTTCCA
ACACAGGCTGGCTAATGCT -> CACAGGCTGGCTAATGCTT
TACTGTCGGCGTCGGAAGT -> ACTGTCGGCGTCGGAAGTG
TACACACCTCGTCTGGGTA -> ACACACCTCGTCTGGGTAG
CGAGCCGATGGTGTTGAAA -> GAGCCGATGGTGTTGAAAA
GGTTCAAAGGCAGTAAATG -> GTTCAAAGGCAGTAAATGT
GTCAGAGGCTAGCAGAATT -> TCAGAGGCTAGCAGAATTA
GTCCGTAGAAGCGGTGCGG -> TCCGTAGAAGCGGTGCGGG
AGGCATTTTGGTAGCAACG -> GGCATTTTGGTAGCAACGA
CTCGTGGTCACAGTGGTGA -> TCGTGGTCACAGTGGTGAC
CGGCTGAGAAGCATAACTG -> GGCTGAGAAGCATAACTGC
ACCATCATGAGTGTCGACC -> CCATCATGAGTGTCGACCT
AACCATCGTAGAACGTTGA -> ACCATCGTAGAACGTTGAT
CGGTGCGGGTTACATTCTT -> GGTGCGGGTTACATTCTTA
GGCTGAGAAACTGTGTTCT -> GCTGAGAAACTGTGTTCTC
CATCAAAACATGCGGGAAT -> ATCAAAACATGCGGGAATT
CAGGGACTCTACCAACCCT -> AGGGACTCTACCAACCCTT
ATAAAGGCCGAGAGGAAAT -> TAAAGGCCGAGAGGAAATA
TTTGGTTTACCCGTAGAGG -> TTGGTTTACCCGTAGAGGC
AGAAACGGTTGGCCAGCAT -> GAAACGGTTGGCCAGCATA
TGTGAAAGAACCGCTGTGC -> GTGAAAGAACCGCTGTGCT
GGGTTTGGTCTTTGTTTTT -> GGTTTGGTCTTTGTTTTTT
CCCGAGGAAAACGGACTTA -> CCGAGGAAAACGGACTTAC
GTCGGTCTTTGCGTGGATT -> TCGGTCTTTGCGTGGATTA
GGTTTACCCGTAGAGGCAC -> GTTTACCCGTAGAGGCACG
TGAAATTGGCGTCCTAGGG -> GAAATTGGCGTCCTAGGGT
CACTACGAAGGCCTATCGA -> ACTACGAAGGCCTATCGAC
TCCCATCTCAGTCTATGCT -> CCCATCTCAGTCTATGCTC
CATTCTTATGGCGTGGATC -> ATTCTTATGGCGTGGATCT
CAGATCTAATGGCAGAGAG -> AGATCTAATGGCAGAGAGG
CAGGCTGGCACCGGCGTAA -> AGGCTGGCACCGGCGTAAA
ACGGACTTACTAATTCCGG -> CGGACTTACTAATTCCGGT
GGAAATACACAGGCTGTGG -> GAAATACACAGGCTGTGGA
CACACTTCTTGAGATTAAC -> ACACTTCTTGAGATTAACA
ATCGACAAACTGTGCTCCA -> TCGACAAACTGTGCTCCAG
CCTTACGGTATTCACTCGT -> CTTACGGTATTCACTCGTG
ACAGGCTGTGGAAATACAC -> CAGGCTGTGGAAATACACA
AAACCGCGCCTTCCATATC -> AACCGCGCCTTCCATATCC
CGAAGCAGCAGGTCGCTTG -> GAAGCAGCAGGTCGCTTGG
TGCGCGCCAGGTTACGTTT -> GCGCGCCAGGTTACGTTTA
TGGCGTCCTAGGGTTCAAA -> GGCGTCCTAGGGTTCAAAG
ATAACTCTAGTGAGGGCTA -> TAACTCTAGTGAGGGCTAG
TTAGTGCCAGTTGTTTACG -> TAGTGCCAGTTGTTTACGA
AGCAGGTCGCTTGGTAGCT -> GCAGGTCGCTTGGTAGCTA
TGAAAGAACCGCTGTGCTG -> GAAAGAACCGCTGTGCTGA
GGGTTCAAAGGCAGTAAAT -> GGTTCAAAGGCAGTAAATG
GTTCAAAGGCAGTAAATGT -> TTCAAAGGCAGTAAATGTA
TCCGCCGCCCCTATGTGTC -> CCGCCGCCCCTATGTGTCA
GTGGACCCGCAAAGTGTCT -> TGGACCCGCAAAGTGTCTC
GCAGGTCGCTTGGTAGCTA -> CAGGTCGCTTGGTAGCTAC
CTCAACCATACCCGTGGAC -> TCAACCATACCCGTGGACG
TCACAGTGGTGACGAATGT -> CACAGTGGTGACGAATGTC
TCGACAGAAATCACCCGAG -> CGACAGAAATCACCCGAGG
GGTCTTTGCGTGGATTACC -> GTCTTTGCGTGGATTACCT
TTGCGCGCCAGGTTACGTT -> TGCGCGCCAGGTTACGTTT
CCGCAGTGACGAATAGTAC -> CGCAGTGACGAATAGTACG
GAATTAGGTGTATGAATCT -> AATTAGGTGTATGAATCTG
CCCGTGGACGTGCCTAGGA -> CCGTGGACGTGCCTAGGAC
GCTGGCACCGGCGTAAACC -> CTGGCACCGGCGTAAACCG
TCAGCGCTCTACGCCACTA -> CAGCGCTCTACGCCACTAC
GAACTCCACCCAGTTCCTG -> AACTCCACCCAGTTCCTGC
CTCACAAGAAGCTGAAATT -> TCACAAGAAGCTGAAATTA
ACTGTTTCACTCACTCTAT -> CTGTTTCACTCACTCTATA
ACGGTTCTCAGACGCTTAT -> CGGTTCTCAGACGCTTATG
AACTATATTTCACGGACTA -> ACTATATTTCACGGACTAC
AGGTTCAACACACAGATTA -> GGTTCAACACACAGATTAC
TTTGGTCTTTGTTTTTTTC -> TTGGTCTTTGTTTTTTTCG
GCGAGGGAGGGAGCCGCGC -> CGAGGGAGGGAGCCGCGCC
CCAGTTCCTGCACGACTCA -> CAGTTCCTGCACGACTCAA
AAGAGCCGAGTTGACCACA -> AGAGCCGAGTTGACCACAG
GTGCTCCAGTGCCTGGAGC -> TGCTCCAGTGCCTGGAGCT
CTGGTAGTGGTCCGCCTTT -> TGGTAGTGGTCCGCCTTTA
ATACACAGGCTGTGGAAAT -> TACACAGGCTGTGGAAATA
TTATGCCGTGCAAACCGCA -> TATGCCGTGCAAACCGCAG
AGAAACTGTGTTCTCGTAT -> GAAACTGTGTTCTCGTATG
ACGCAGCAGCATTCACGCC -> CGCAGCAGCATTCACGCCT
GATCGTCGGTAGTCCGTAC -> ATCGTCGGTAGTCCGTACG
GCGGGAATTTGTGGACCCG -> CGGGAATTTGTGGACCCGC
TTATGGCGTGGATCTCGCC -> TATGGCGTGGATCTCGCCG
CCCGTAGAGGCACGGCTAT -> CCGTAGAGGCACGGCTATT
CGGAAATACACAGGCTGTG -> GGAAATACACAGGCTGTGG
TCTCGATCGTCGGTAGTCC -> CTCGATCGTCGGTAGTCCG
CGAGTAGACTGTATACGGC -> GAGTAGACTGTATACGGCC
GCGCCAGGTTACGTTTATC -> CGCCAGGTTACGTTTATCC
CTGCCATGGGAAAATCGAG -> TGCCATGGGAAAATCGAGC
GTGCCTAGGACGAGTAGAC -> TGCCTAGGACGAGTAGACT
GATGCTCCTAAACATGGTT -> ATGCTCCTAAACATGGTTA
TCGACTTCGAGAACTCCAC -> CGACTTCGAGAACTCCACC
TTATAAACAGTAACCGGAA -> TATAAACAGTAACCGGAAA
ACCCTCTCACTCAGGCATT -> CCCTCTCACTCAGGCATTT
CCTTGCGCGCCAGGTTACG -> CTTGCGCGCCAGGTTACGT
CTATTCGTACGTGTACTGT -> TATTCGTACGTGTACTGTC
ATCTGACGAACCCATCAAA -> TCTGACGAACCCATCAAAA
TTCGAGAACTCCACCCAGT -> TCGAGAACTCCACCCAGTT
CTACGGTTCTCAGACGCTT -> TACGGTTCTCAGACGCTTA
GCAATGCCTGCTGGACCAC -> CAATGCCTGCTGGACCACA
ATAACTGCCCAGCTTTAAC -> TAACTGCCCAGCTTTAACC
GCTCGTCGGTAAACGCAGA -> CTCGTCGGTAAACGCAGAT
GTAGTTCTCCCATCTCAGT -> TAGTTCTCCCATCTCAGTC
CAGAATTAGGGACGAGGTT -> AGAATTAGGGACGAGGTTC
CAGTAACCGGAAATACACA -> AGTAACCGGAAATACACAG
AGCAAGCCGGAACTTTGTC -> GCAAGCCGGAACTTTGTCG
TTCTCTATGATGCTAATGG -> TCTCTATGATGCTAATGGA
TATTTTGCAGGAGCTCTCA -> ATTTTGCAGGAGCTCTCAA
GTATGAATCTGGATCAGCT -> TATGAATCTGGATCAGCTC
TCGTCTGGGTAGTTCTCCC -> CGTCTGGGTAGTTCTCCCA
ATATCCCGCTAGAAGAGTA -> TATCCCGCTAGAAGAGTAA
TTGCAGGAGCTCTCAACCA -> TGCAGGAGCTCTCAACCAT
CATTCTCTATGATGCTAAT -> ATTCTCTATGATGCTAATG
GTTTACGACCCGCAATTAG -> TTTACGACCCGCAATTAGA
AACTTTGTCGACAGAAATC -> ACTTTGTCGACAGAAATCA
TCCATATGTGGAAGTCTGG -> CCATATGTGGAAGTCTGGT
ATGGCAGAGAGGTGCCCCC -> TGGCAGAGAGGTGCCCCCT
GAAACTGTGTTCTCGTATG -> AAACTGTGTTCTCGTATGC
GACCCGCAAAGTGTCTCAA -> ACCCGCAAAGTGTCTCAAA
CAGATTACGCCTCTGCGTC -> AGATTACGCCTCTGCGTCT
GACAGAAATCACCCGAGGC -> ACAGAAATCACCCGAGGCC
ACCCTTACGGAGTTAAAAA -> CCCTTACGGAGTTAAAAAT
CTTGAGATTAACAGTGTGT -> TTGAGATTAACAGTGTGTT
GATCCGCGCCTTCCATATC -> ATCCGCGCCTTCCATATCC
CTATATTTCACGGACTACG -> TATATTTCACGGACTACGA
CATGCCACGGGCCACAGAA -> ATGCCACGGGCCACAGAAA
CATATCCCGGCCGCCGTGT -> ATATCCCGGCCGCCGTGTG
TCGTACGTGTACTGTCGGC -> CGTACGTGTACTGTCGGCG
AATCTGACGAACCCATCAA -> ATCTGACGAACCCATCAAA
ACAAAACCATCGTAGAACG -> CAAAACCATCGTAGAACGT
AGTCTCCAACACTGAACTA -> GTCTCCAACACTGAACTAT
GCTAAGAGAGATAGAATAC -> CTAAGAGAGATAGAATACA
ACGGTATTCACTCGTGGTC -> CGGTATTCACTCGTGGTCA
AACGGGAAATACACAGGCT -> ACGGGAAATACACAGGCTG
TGTTCTCGTATGCGCACGC -> GTTCTCGTATGCGCACGCA
GTGTGAAAGAACCGCTGTG -> TGTGAAAGAACCGCTGTGC
GAGATAGAATACAAGGTAC -> AGATAGAATACAAGGTACG
GGGAAATACACAGGCTGGC -> GGAAATACACAGGCTGGCG
GACTTTAGTGCCAGTTGTT -> ACTTTAGTGCCAGTTGTTT
GCCTGTATGTTAAGGTCCA -> CCTGTATGTTAAGGTCCAT
TCGATCGTCGGTAGTCCGT -> CGATCGTCGGTAGTCCGTA
CGGTAAACGCAGATCTAAT -> GGTAAACGCAGATCTAATG
AGTGAGGGCTAGCGTTATT -> GTGAGGGCTAGCGTTATTC
CACACTCAGTCGATTCGAT -> ACACTCAGTCGATTCGATA
CGTCTGGGTAGTTCTCCCA -> GTCTGGGTAGTTCTCCCAT
TAAACCGCGCCTTCCATAT -> AAACCGCGCCTTCCATATC
TCAGGGACTCTACCAACCC -> CAGGGACTCTACCAACCCT
ATGATAGCTCGCGCTAGTG -> TGATAGCTCGCGCTAGTGT
TAATGGAGTCATGTCTCGA -> AATGGAGTCATGTCTCGAT
CCGATGGTGTTGAAAAGAG -> CGATGGTGTTGAAAAGAGC
TCGGAATTAACTCTCATGC -> CGGAATTAACTCTCATGCC
TTACGAAGCAGCAGGTCGC -> TACGAAGCAGCAGGTCGCT
TGTCGACAGAAATCACCCG -> GTCGACAGAAATCACCCGA
AGTGTCTCAAATAACTCAT -> GTGTCTCAAATAACTCATT
GTTTGGTCTTTGTTTTTTT -> TTTGGTCTTTGTTTTTTTC
GAAGTCTGGTATGAGTATT -> AAGTCTGGTATGAGTATTT
GTTCAACACACAGATTACG -> TTCAACACACAGATTACGC
GCTGTGGAAATACACAGGC -> CTGTGGAAATACACAGGCT
TCGGTTTGGTTTACCCGTA -> CGGTTTGGTTTACCCGTAG
ATTCGTACGTGTACTGTCG -> TTCGTACGTGTACTGTCGG
GTATTTTGCAGGAGCTCTC -> TATTTTGCAGGAGCTCTCA
TCCATATCCCGCTAGAAGA -> CCATATCCCGCTAGAAGAG
CGAGGAAAACGGACTTACT -> GAGGAAAACGGACTTACTA
AGAATACAAGGTACGCACA -> GAATACAAGGTACGCACAC
AGTGCCAGTTGTTTACGAC -> GTGCCAGTTGTTTACGACC
CGCTGTGCTGAAACCAAAG -> GCTGTGCTGAAACCAAAGT
TTGTCGATTCCATGCACCG -> TGTCGATTCCATGCACCGT
ATTCGATATGTCTGAGGAT -> TTCGATATGTCTGAGGATG
TCTCCCATCTCAGTCTATG -> CTCCCATCTCAGTCTATGC
TGCACGACTCAAGCAAGCC -> GCACGACTCAAGCAAGCCG
GCTGCCATGGGAAAATCGA -> CTGCCATGGGAAAATCGAG
CGGTTCTCAGACGCTTATG -> GGTTCTCAGACGCTTATGC
AACCCTCTCACTCAGGCAT -> ACCCTCTCACTCAGGCATT
CCTCTGCGTCTGGCCTGTA -> CTCTGCGTCTGGCCTGTAT
CATGTCTCGATCGTCGGTA -> ATGTCTCGATCGTCGGTAG
TAGCTCGCGCTAGTGTCCC -> AGCTCGCGCTAGTGTCCCC
ATACAAGGTACGCACACTC -> TACAAGGTACGCACACTCA
GATGAGCTCTGCGACTGTT -> ATGAGCTCTGCGACTGTTT
TAGTGAGGGCTAGCGTTAT -> AGTGAGGGCTAGCGTTATT
GTTAATGAGATGATAGCTC -> TTAATGAGATGATAGCTCG
GATCAGCTCGTCGGTAAAC -> ATCAGCTCGTCGGTAAACG
AATTTTGTCGATTCCATGC -> ATTTTGTCGATTCCATGCA
AATTCCGGTCGGTCTTTGC -> ATTCCGGTCGGTCTTTGCG
GGTGCCCCCTCAGCGCCGG -> GTGCCCCCTCAGCGCCGGC
CACCATCATGAGTGTCGAC -> ACCATCATGAGTGTCGACC
ACAGTCAGAGGCTAGCAGA -> CAGTCAGAGGCTAGCAGAA
GCAATTAGAGTTTACGAAG -> CAATTAGAGTTTACGAAGC
ATGTGTCAAGATGGAACCG -> TGTGTCAAGATGGAACCGG
ACTCCTGGTAGTGGTCCGC -> CTCCTGGTAGTGGTCCGCC
AGTGTCGACCTAATCCCTA -> GTGTCGACCTAATCCCTAT
AGTTCGGTGAATGCCACTA -> GTTCGGTGAATGCCACTAT
GCACCATCATGAGTGTCGA -> CACCATCATGAGTGTCGAC
TCGATTCCATGCACCGTCC -> CGATTCCATGCACCGTCCC
CACAGTGGTGACGAATGTC -> ACAGTGGTGACGAATGTCC
CGCATAACTCTAGTGAGGG -> GCATAACTCTAGTGAGGGC
TGTTAAGGTCCATATGTGG -> GTTAAGGTCCATATGTGGA
GGAAATACACAGGCTGGCT -> GAAATACACAGGCTGGCTA
CATCGTAGAACGTTGATTG -> ATCGTAGAACGTTGATTGG
AATACAAGGTACGCACACT -> ATACAAGGTACGCACACTC
CCGTAGAAGCGGTGCGGGT -> CGTAGAAGCGGTGCGGGTT
CTACCGGTGGGCTAATCGA -> TACCGGTGGGCTAATCGAC
GCTTTAACCCTCTCACTCA -> CTTTAACCCTCTCACTCAG
AATCTGGATCAGCTCGTCG -> ATCTGGATCAGCTCGTCGG
CCGTCCCTGAAATTGGCGT -> CGTCCCTGAAATTGGCGTC
TGACAAAACCATCGTAGAA -> GACAAAACCATCGTAGAAC
CTCAAGCAAGCCGGAACTT -> TCAAGCAAGCCGGAACTTT
TCTATGATGCTAATGGAGT -> CTATGATGCTAATGGAGTC
TGGTATGAGTATTTTGCAG -> GGTATGAGTATTTTGCAGG
CGATCGGTGGTCGCTCGGT -> GATCGGTGGTCGCTCGGTT
GTGACGTACGACGTGAGGT -> TGACGTACGACGTGAGGTA
CTTATCCGCCGCCCCTATG -> TTATCCGCCGCCCCTATGT
CCAGCTTTAACCCTCTCAC -> CAGCTTTAACCCTCTCACT
CCTTCCATATCCCGCTAGA -> CTTCCATATCCCGCTAGAA
ATAATTTTGTCGATTCCAT -> TAATTTTGTCGATTCCATG
TGGTGACGAATGTCCGTAG -> GGTGACGAATGTCCGTAGA
GCCTGGAGCTTTTGGCACA -> CCTGGAGCTTTTGGCACAC
TAAGGCAATGCCTGCTGGA -> AAGGCAATGCCTGCTGGAC
GGCGTCGGAAGTGGAGGTG -> GCGTCGGAAGTGGAGGTGG
CCCGTGCGATCGGTGGTCG -> CCGTGCGATCGGTGGTCGC
ACGACCCGCAATTAGAGTT -> CGACCCGCAATTAGAGTTT
TGCCTGGAGCTTTTGGCAC -> GCCTGGAGCTTTTGGCACA
CCTGAAATTGGCGTCCTAG -> CTGAAATTGGCGTCCTAGG
AACGAACATGCTAAGAGAG -> ACGAACATGCTAAGAGAGA
AATTAACTCTCATGCCACG -> ATTAACTCTCATGCCACGG
AATGACGATAATCACACAG -> ATGACGATAATCACACAGT
TTATCCGCCGCCCCTATGT -> TATCCGCCGCCCCTATGTG
AACTGTGCTCCAGTGCCTG -> ACTGTGCTCCAGTGCCTGG
GAAATACACAGGCTGGCGA -> AAATACACAGGCTGGCGAG
CGACGCAATCTTATCCGCC -> GACGCAATCTTATCCGCCG
TGCTCCTAAACATGGTTAA -> GCTCCTAAACATGGTTAAT
CCTATTGGTGACGTACGAC -> CTATTGGTGACGTACGACG
ACGAATGTCCGTAGAAGCG -> CGAATGTCCGTAGAAGCGG
TGACTGCGGGCGTCCCATA -> GACTGCGGGCGTCCCATAA
GTCTCCAACACTGAACTAT -> TCTCCAACACTGAACTATA
CGCGGCAGAACCTCCCCGT -> GCGGCAGAACCTCCCCGTT
TCGTCGGTAGTCCGTACGG -> CGTCGGTAGTCCGTACGGA
AGTGTCCCCGTGTCGAGCG -> GTGTCCCCGTGTCGAGCGA
ATGTGGAAGTCTGGTATGA -> TGTGGAAGTCTGGTATGAG
CAGGTCGCTTGGTAGCTAC -> AGGTCGCTTGGTAGCTACC
TACGAAGCAGCAGGTCGCT -> ACGAAGCAGCAGGTCGCTT
GCTCGGTTTGGTTTACCCG -> CTCGGTTTGGTTTACCCGT
TATCGACTTCGAGAACTCC -> ATCGACTTCGAGAACTCCA
GTTCTCAGACGCTTATGCC -> TTCTCAGACGCTTATGCCG
CTCAGTCGATTCGATATGT -> TCAGTCGATTCGATATGTC
CTATCGACTTCGAGAACTC -> TATCGACTTCGAGAACTCC
CAGCTCGTCGGTAAACGCA -> AGCTCGTCGGTAAACGCAG
GAGGTGCCCCCTCAGCGCC -> AGGTGCCCCCTCAGCGCCG
AGAACGTTGATTGGAGACG -> GAACGTTGATTGGAGACGT
CTATGTGTCAAGATGGAAC -> TATGTGTCAAGATGGAACC
CGTGCAAACCGCAGTGCAA -> GTGCAAACCGCAGTGCAAG
TAGGTGTATGAATCTGGAT -> AGGTGTATGAATCTGGATC
GCGTCCTAGGGTTCAAAGG -> CGTCCTAGGGTTCAAAGGC
GGCTGGCTAATGCTTGATC -> GCTGGCTAATGCTTGATCC
GGACGAGTAGACTGTATAC -> GACGAGTAGACTGTATACG
TGTACTGTCGGCGTCGGAA -> GTACTGTCGGCGTCGGAAG
GGGGACTTTAGTGCCAGTT -> GGGACTTTAGTGCCAGTTG
CCGAGAGGAAATACACAGG -> CGAGAGGAAATACACAGGC
TATGATGGCCTTGCGCGCC -> ATGATGGCCTTGCGCGCCA
TGCCGTGCAAACCGCAGTG -> GCCGTGCAAACCGCAGTGC
CGCCTTCCATATCCCGCCT -> GCCTTCCATATCCCGCCTT
AACCGCTGTGCTGAAACCA -> ACCGCTGTGCTGAAACCAA
GTCCCATAACGCGGCAGAA -> TCCCATAACGCGGCAGAAC
ATCCCGGCCGCCGTGTGGT -> TCCCGGCCGCCGTGTGGTC
GGAAATACACAGGCTGGCA -> GAAATACACAGGCTGGCAC
CTATATCAGCGCTCTACGC -> TATATCAGCGCTCTACGCC
CTGCCCAGCTTTAACCCTC -> TGCCCAGCTTTAACCCTCT
CCGAGGAAAACGGACTTAC -> CGAGGAAAACGGACTTACT
CGTGTCGAGCGATGAGCTC -> GTGTCGAGCGATGAGCTCT
GGTAGTGGTCCGCCTTTAT -> GTAGTGGTCCGCCTTTATA
CGCCTTCCATATCCCGCTA -> GCCTTCCATATCCCGCTAG
TCGGTGGTCGCTCGGTTTG -> CGGTGGTCGCTCGGTTTGG
TACGTTTATCCCGGGCTGC -> ACGTTTATCCCGGGCTGCC
TTTGCAGGAGCTCTCAACC -> TTGCAGGAGCTCTCAACCA
CAAAGTTGACTGCGGGCGT -> AAAGTTGACTGCGGGCGTC
CCTTACGGAGTTAAAAATC -> CTTACGGAGTTAAAAATCA
CCCTTACGGAGTTAAAAAT -> CCTTACGGAGTTAAAAATC
TTGCGTGGATTACCTTTTT -> TGCGTGGATTACCTTTTTA
TGTGTCAAGATGGAACCGG -> GTGTCAAGATGGAACCGGT
ACGTGTACTGTCGGCGTCG -> CGTGTACTGTCGGCGTCGG
TATGTGTCAAGATGGAACC -> ATGTGTCAAGATGGAACCG
AGGCTGGCTAATGCTTGAT -> GGCTGGCTAATGCTTGATC
TCCCGCTAGAAGAGTAAAT -> CCCGCTAGAAGAGTAAATA
CGCAGCAGCATTCACGCCT -> GCAGCAGCATTCACGCCTT
TCGATATGTCTGAGGATGC -> CGATATGTCTGAGGATGCT
ATGGCGTGGATCTCGCCGT -> TGGCGTGGATCTCGCCGTT
GTACGTATTGTACACACCT -> TACGTATTGTACACACCTC
TAGACTGTATACGGCCTCA -> AGACTGTATACGGCCTCAA
AGTCGATTCGATATGTCTG -> GTCGATTCGATATGTCTGA
AGCTACCGGTGGGCTAATC -> GCTACCGGTGGGCTAATCG
TTCGGTGAATGCCACTATG -> TCGGTGAATGCCACTATGA
TTCTACGGTTCTCAGACGC -> TCTACGGTTCTCAGACGCT
AGCCCCGAGGAAAACGGAC -> GCCCCGAGGAAAACGGACT
ACGACGCAATCTTATCCGC -> CGACGCAATCTTATCCGCC
ATATCCCGGCCGCCGTGTG -> TATCCCGGCCGCCGTGTGG
TGCCAGTTGTTTACGACCC -> GCCAGTTGTTTACGACCCG
CCAGTTGTTTACGACCCGC -> CAGTTGTTTACGACCCGCA
GACAAAACCATCGTAGAAC -> ACAAAACCATCGTAGAACG
CACCGTCCCTGAAATTGGC -> ACCGTCCCTGAAATTGGCG
TATGTTAAGGTCCATATGT -> ATGTTAAGGTCCATATGTG
TATAATGACGATAATCACA -> ATAATGACGATAATCACAC
GCTGTGCTGAAACCAAAGT -> CTGTGCTGAAACCAAAGTT
TGACGTACGACGTGAGGTA -> GACGTACGACGTGAGGTAA
TCTAGTGAGGGCTAGCGTT -> CTAGTGAGGGCTAGCGTTA
TGGTCCGCGCCTTCCATAT -> GGTCCGCGCCTTCCATATC
GCTTCTACGGTTCTCAGAC -> CTTCTACGGTTCTCAGACG
TCACTCTATATCAGCGCTC -> CACTCTATATCAGCGCTCT
CTGAAATTGGCGTCCTAGG -> TGAAATTGGCGTCCTAGGG
GTTTTTTTCGCGGCTTAAC -> TTTTTTTCGCGGCTTAACA
CACAGGCTGGCACCGGCGT -> ACAGGCTGGCACCGGCGTA
AAGCGGTGCGGGTTACATT -> AGCGGTGCGGGTTACATTC
CCTCTCACTCAGGCATTTT -> CTCTCACTCAGGCATTTTG
CGAGGCCCGTGCGATCGGT -> GAGGCCCGTGCGATCGGTG
AAACATGGTTAATGAGATG -> AACATGGTTAATGAGATGA
CCCATCAAAACATGCGGGA -> CCATCAAAACATGCGGGAA
CGTAAACCGCGCCTTCCAT -> GTAAACCGCGCCTTCCATA
CGGGCTGCCATGGGAAAAT -> GGGCTGCCATGGGAAAATC
CCATATCCCGCAGTGACGA -> CATATCCCGCAGTGACGAA
CTCTCACTCAGGCATTTTG -> TCTCACTCAGGCATTTTGG
CCGCAAAGTGTCTCAAATA -> CGCAAAGTGTCTCAAATAA
GAACCGGTTTCGTCCGCTT -> AACCGGTTTCGTCCGCTTC
AAGCAGTTCGGTGAATGCC -> AGCAGTTCGGTGAATGCCA
CGCAATCTTATCCGCCGCC -> GCAATCTTATCCGCCGCCC
GAGCCGATGGTGTTGAAAA -> AGCCGATGGTGTTGAAAAG
CGTCCGCTTCTACGGTTCT -> GTCCGCTTCTACGGTTCTC
CACAGATTACGCCTCTGCG -> ACAGATTACGCCTCTGCGT
ATATCCCGCCTTACGGTAT -> TATCCCGCCTTACGGTATT
CCTTTATACCATCACAAAA -> CTTTATACCATCACAAAAG
CTCCTAAACATGGTTAATG -> TCCTAAACATGGTTAATGA
TAATTTTGTCGATTCCATG -> AATTTTGTCGATTCCATGC
ACTTTGTCGACAGAAATCA -> CTTTGTCGACAGAAATCAC
TCTTTGTTTTTTTCGCGGC -> CTTTGTTTTTTTCGCGGCT
TCACTCACTCTATATCAGC -> CACTCACTCTATATCAGCG
TCCTGCACGACTCAAGCAA -> CCTGCACGACTCAAGCAAG
GGCAGAGAGGTGCCCCCTC -> GCAGAGAGGTGCCCCCTCA
TCATTATCAGCTCACAAGA -> CATTATCAGCTCACAAGAA
AGAGGCACGGCTATTCGTA -> GAGGCACGGCTATTCGTAC
GGCCTATCGACTTCGAGAA -> GCCTATCGACTTCGAGAAC
AGAACTCCACCCAGTTCCT -> GAACTCCACCCAGTTCCTG
GAGAAACTGTGTTCTCGTA -> AGAAACTGTGTTCTCGTAT
CGCAAAGTGTCTCAAATAA -> GCAAAGTGTCTCAAATAAC
TCCCTGAAATTGGCGTCCT -> CCCTGAAATTGGCGTCCTA
ACTCTACCAACCCTTACGG -> CTCTACCAACCCTTACGGA
AAACCAAAGTTGACTGCGG -> AACCAAAGTTGACTGCGGG
AGGCTGTGGAAATACACAG -> GGCTGTGGAAATACACAGG
AAACGGTTGGCCAGCATAA -> AACGGTTGGCCAGCATAAA
CGATATGTCTGAGGATGCT -> GATATGTCTGAGGATGCTC
GACTTCGAGAACTCCACCC -> ACTTCGAGAACTCCACCCA
GTGTCCCCGTGTCGAGCGA -> TGTCCCCGTGTCGAGCGAT
ATTTCACGGACTACGACGC -> TTTCACGGACTACGACGCA
CAGGCTGGCTAATGCTTGA -> AGGCTGGCTAATGCTTGAT
AGTTGTTTACGACCCGCAA -> GTTGTTTACGACCCGCAAT
CAACCCTTACGGAGTTAAA -> AACCCTTACGGAGTTAAAA
CTTGATCCGCGCCTTCCAT -> TTGATCCGCGCCTTCCATA
CAGGAGCTCTCAACCATAC -> AGGAGCTCTCAACCATACC
GCCTCTGCGTCTGGCCTGT -> CCTCTGCGTCTGGCCTGTA
ATTGGAGACGTCACCGGTA -> TTGGAGACGTCACCGGTAG
ACAAGGTACGCACACTCAG -> CAAGGTACGCACACTCAGT
TATGTGGAAGTCTGGTATG -> ATGTGGAAGTCTGGTATGA
GGGCCACAGAAACGGTTGG -> GGCCACAGAAACGGTTGGC
CCGGTAGCGGGTTTGGTCT -> CGGTAGCGGGTTTGGTCTT
ACGGCTATTCGTACGTGTA -> CGGCTATTCGTACGTGTAC
TTTTTTTCGCGGCTTAACA -> TTTTTTCGCGGCTTAACAA
GGACTACGACGCAATCTTA -> GACTACGACGCAATCTTAT
CTCGCGCTAGTGTCCCCGT -> TCGCGCTAGTGTCCCCGTG
TAATGCTTGATCCGCGCCT -> AATGCTTGATCCGCGCCTT
AGAATTAGGGACGAGGTTC -> GAATTAGGGACGAGGTTCA
GAGGTTCAACACACAGATT -> AGGTTCAACACACAGATTA
GGCTGTGGAAATACACAGG -> GCTGTGGAAATACACAGGC
ATCGTAGAACGTTGATTGG -> TCGTAGAACGTTGATTGGA
AAATTAAGCATTCTCTATG -> AATTAAGCATTCTCTATGA
TCCTAAACATGGTTAATGA -> CCTAAACATGGTTAATGAG
ACTGTATACGGCCTCAATC -> CTGTATACGGCCTCAATCT
TGACGATAATCACACAGTC -> GACGATAATCACACAGTCA
TATCCCGGGCTGCCATGGG -> ATCCCGGGCTGCCATGGGA
GAAAAGAGCCGAGTTGACC -> AAAAGAGCCGAGTTGACCA
TCAGTCGATTCGATATGTC -> CAGTCGATTCGATATGTCT
CCAAAGTTGACTGCGGGCG -> CAAAGTTGACTGCGGGCGT
ACCACAGGATGACAAAACC -> CCACAGGATGACAAAACCA
TGTATACGGCCTCAATCTG -> GTATACGGCCTCAATCTGA
CGCCGGCTGAGAAGCATAA -> GCCGGCTGAGAAGCATAAC
TGAGATGATAGCTCGCGCT -> GAGATGATAGCTCGCGCTA
TCCTAGGGTTCAAAGGCAG -> CCTAGGGTTCAAAGGCAGT
AAGCACCATCATGAGTGTC -> AGCACCATCATGAGTGTCG
TGTGGAAGTCTGGTATGAG -> GTGGAAGTCTGGTATGAGT
GGCCGAGAGGAAATACACA -> GCCGAGAGGAAATACACAG
GAGGCCCGTGCGATCGGTG -> AGGCCCGTGCGATCGGTGG
GGCCACAGAAACGGTTGGC -> GCCACAGAAACGGTTGGCC
CTGTTTCACTCACTCTATA -> TGTTTCACTCACTCTATAT
ATACACAGGCTGGCTAATG -> TACACAGGCTGGCTAATGC
CACTCACTCTATATCAGCG -> ACTCACTCTATATCAGCGC
AGAGGCTAGCAGAATTAGG -> GAGGCTAGCAGAATTAGGG
AGAGCCGAGTTGACCACAG -> GAGCCGAGTTGACCACAGG
TGATGGCCTTGCGCGCCAG -> GATGGCCTTGCGCGCCAGG
TTCTTGAGATTAACAGTGT -> TCTTGAGATTAACAGTGTG
GGTCGCTCGGTTTGGTTTA -> GTCGCTCGGTTTGGTTTAC
AAAGGCCGAGAGGAAATAC -> AAGGCCGAGAGGAAATACA
AAGTTGACTGCGGGCGTCC -> AGTTGACTGCGGGCGTCCC
TGCAACTCCTGGTAGTGGT -> GCAACTCCTGGTAGTGGTC
ACACACAGATTACGCCTCT -> CACACAGATTACGCCTCTG
CAAGAAGCTGAAATTAAGC -> AAGAAGCTGAAATTAAGCA
GGTGTATGAATCTGGATCA -> GTGTATGAATCTGGATCAG
AGCCGAGTTGACCACAGGA -> GCCGAGTTGACCACAGGAT
TGGAAGTCTGGTATGAGTA -> GGAAGTCTGGTATGAGTAT
AGTGCGCATAACTCTAGTG -> GTGCGCATAACTCTAGTGA
CGCCGTTAAGCACCATCAT -> GCCGTTAAGCACCATCATG
TAACTCTCATGCCACGGGC -> AACTCTCATGCCACGGGCC
TCGGCGTCGGAAGTGGAGG -> CGGCGTCGGAAGTGGAGGT
CCACCCAGTTCCTGCACGA -> CACCCAGTTCCTGCACGAC
GGAAAATCGAGCCGATGGT -> GAAAATCGAGCCGATGGTG
GCATAACTGCCCAGCTTTA -> CATAACTGCCCAGCTTTAA
GTCGACAGAAATCACCCGA -> TCGACAGAAATCACCCGAG
ACCTCGTCTGGGTAGTTCT -> CCTCGTCTGGGTAGTTCTC
CTGAGAAGCATAACTGCCC -> TGAGAAGCATAACTGCCCA
GTAGAAGCGGTGCGGGTTA -> TAGAAGCGGTGCGGGTTAC
CTCCCCGTTTTCGCATATT -> TCCCCGTTTTCGCATATTC
GCCGATGGTGTTGAAAAGA -> CCGATGGTGTTGAAAAGAG
CGACCTAATCCCTATGCGT -> GACCTAATCCCTATGCGTG
CGTCCTAGGGTTCAAAGGC -> GTCCTAGGGTTCAAAGGCA
CACAAAAGCGTGTAAGCAG -> ACAAAAGCGTGTAAGCAGT
ACCCGCAATTAGAGTTTAC -> CCCGCAATTAGAGTTTACG
TGCGGGTTACATTCTTATG -> GCGGGTTACATTCTTATGG
GTTGTTTACGACCCGCAAT -> TTGTTTACGACCCGCAATT
CCGCTGTGCTGAAACCAAA -> CGCTGTGCTGAAACCAAAG
CTAGTGTCCCCGTGTCGAG -> TAGTGTCCCCGTGTCGAGC
GTCGCTCGGTTTGGTTTAC -> TCGCTCGGTTTGGTTTACC
CAGTCTATGCTCAGGGACT -> AGTCTATGCTCAGGGACTC
TTAATGAGATGATAGCTCG -> TAATGAGATGATAGCTCGC
ACGAGGTTCAACACACAGA -> CGAGGTTCAACACACAGAT
CTAGGACGAGTAGACTGTA -> TAGGACGAGTAGACTGTAT
CCCGAGGCCCGTGCGATCG -> CCGAGGCCCGTGCGATCGG
ATTTTGTCGATTCCATGCA -> TTTTGTCGATTCCATGCAC
TTTTCGCGGCTTAACAACG -> TTTCGCGGCTTAACAACGG
AAGATGGAACCGGTTTCGT -> AGATGGAACCGGTTTCGTC
ACAGGCTGGCGAGGGAGGG -> CAGGCTGGCGAGGGAGGGA
CAAAGGCAGTAAATGTAAG -> AAAGGCAGTAAATGTAAGA
AGACGTCACCGGTAGCGGG -> GACGTCACCGGTAGCGGGT
TCAGTGCGCATAACTCTAG -> CAGTGCGCATAACTCTAGT
CGAGTTGACCACAGGATGA -> GAGTTGACCACAGGATGAC
TGCTAAGAGAGATAGAATA -> GCTAAGAGAGATAGAATAC
ATGAGTATTTTGCAGGAGC -> TGAGTATTTTGCAGGAGCT
GTATACGGCCTCAATCTGA -> TATACGGCCTCAATCTGAC
AGAACCTCCCCGTTTTCGC -> GAACCTCCCCGTTTTCGCA
CGCCGTGTGGTCCGCGCCT -> GCCGTGTGGTCCGCGCCTT
TCGCGCTAGTGTCCCCGTG -> CGCGCTAGTGTCCCCGTGT
TGGAGTCATGTCTCGATCG -> GGAGTCATGTCTCGATCGT
TGATTGGAGACGTCACCGG -> GATTGGAGACGTCACCGGT
AGGCCTATCGACTTCGAGA -> GGCCTATCGACTTCGAGAA
GACGTCACCGGTAGCGGGT -> ACGTCACCGGTAGCGGGTT
TTGATTGGAGACGTCACCG -> TGATTGGAGACGTCACCGG
CTTTGTCGACAGAAATCAC -> TTTGTCGACAGAAATCACC
AAATGTAAGAATTAGGTGT -> AATGTAAGAATTAGGTGTA
GTGGAAATACACAGGCTGG -> TGGAAATACACAGGCTGGC
GCATTCTCTATGATGCTAA -> CATTCTCTATGATGCTAAT
CCATCTCAGTCTATGCTCA -> CATCTCAGTCTATGCTCAG
GGAGACGTCACCGGTAGCG -> GAGACGTCACCGGTAGCGG
GCGTGGATCTCGCCGTTAA -> CGTGGATCTCGCCGTTAAG
TAATTCCGGTCGGTCTTTG -> AATTCCGGTCGGTCTTTGC
GTATTCACTCGTGGTCACA -> TATTCACTCGTGGTCACAG
TGTTTTTTTCGCGGCTTAA -> GTTTTTTTCGCGGCTTAAC
GTCTGCAACTCCTGGTAGT -> TCTGCAACTCCTGGTAGTG
ATCTCGCCGTTAAGCACCA -> TCTCGCCGTTAAGCACCAT
AAGCTGAAATTAAGCATTC -> AGCTGAAATTAAGCATTCT
GAGTAGACTGTATACGGCC -> AGTAGACTGTATACGGCCT
TCACGCCTTCGGTCTGCAA -> CACGCCTTCGGTCTGCAAC
TCCACCCAGTTCCTGCACG -> CCACCCAGTTCCTGCACGA
TGGACGTGCCTAGGACGAG -> GGACGTGCCTAGGACGAGT
GAAATTGGCGTCCTAGGGT -> AAATTGGCGTCCTAGGGTT
AAGCCCCGAGGAAAACGGA -> AGCCCCGAGGAAAACGGAC
AGTCATGTCTCGATCGTCG -> GTCATGTCTCGATCGTCGG
GCGGCTTAACAACGGGAAA -> CGGCTTAACAACGGGAAAT
GTTAAGGTCCATATGTGGA -> TTAAGGTCCATATGTGGAA
GCGGTGCGGGTTACATTCT -> CGGTGCGGGTTACATTCTT
CAGAAACGGTTGGCCAGCA -> AGAAACGGTTGGCCAGCAT
CAGACGCTTATGCCGTGCA -> AGACGCTTATGCCGTGCAA
GCTAATGCTTGATCCGCGC -> CTAATGCTTGATCCGCGCC
AATGGAGTCATGTCTCGAT -> ATGGAGTCATGTCTCGATC
CGTCGGTAAACGCAGATCT -> GTCGGTAAACGCAGATCTA
GAGTATTTTGCAGGAGCTC -> AGTATTTTGCAGGAGCTCT
TTTTGTCGATTCCATGCAC -> TTTGTCGATTCCATGCACC
CAAAACATGCGGGAATTTG -> AAAACATGCGGGAATTTGT
AATTAGGGACGAGGTTCAA -> ATTAGGGACGAGGTTCAAC
GGTAGCGGGTTTGGTCTTT -> GTAGCGGGTTTGGTCTTTG
ATCATGAGTGTCGACCTAA -> TCATGAGTGTCGACCTAAT
CTGCTGGACCACACGAAGT -> TGCTGGACCACACGAAGTG
CCATCATGAGTGTCGACCT -> CATCATGAGTGTCGACCTA
ACTTCTTGAGATTAACAGT -> CTTCTTGAGATTAACAGTG
GCAAACCGCAGTGCAAGCC -> CAAACCGCAGTGCAAGCCC
TGGATTACCTTTTTATAAA -> GGATTACCTTTTTATAAAC
CCCAGCTTTAACCCTCTCA -> CCAGCTTTAACCCTCTCAC
TCAGCTCACAAGAAGCTGA -> CAGCTCACAAGAAGCTGAA
TGTTGAAAAGAGCCGAGTT -> GTTGAAAAGAGCCGAGTTG
GCGCTCTACGCCACTACGA -> CGCTCTACGCCACTACGAA
CTGTATGTTAAGGTCCATA -> TGTATGTTAAGGTCCATAT
TAAACATGGTTAATGAGAT -> AAACATGGTTAATGAGATG
AAACCATCGTAGAACGTTG -> AACCATCGTAGAACGTTGA
GGTAGCTACCGGTGGGCTA -> GTAGCTACCGGTGGGCTAA
TTACCTTTTTATAAACAGT -> TACCTTTTTATAAACAGTA
AAACGCAGATCTAATGGCA -> AACGCAGATCTAATGGCAG
TGGTTTACCCGTAGAGGCA -> GGTTTACCCGTAGAGGCAC
TGTCAAGATGGAACCGGTT -> GTCAAGATGGAACCGGTTT
TTATAATGACGATAATCAC -> TATAATGACGATAATCACA
TGATGCTAATGGAGTCATG -> GATGCTAATGGAGTCATGT
CCCCGTGTCGAGCGATGAG -> CCCGTGTCGAGCGATGAGC
GTTAAGCACCATCATGAGT -> TTAAGCACCATCATGAGTG
CGCACACTCAGTCGATTCG -> GCACACTCAGTCGATTCGA
GCACACTCAGTCGATTCGA -> CACACTCAGTCGATTCGAT
CACGGGCCACAGAAACGGT -> ACGGGCCACAGAAACGGTT
GCTTATGCCGTGCAAACCG -> CTTATGCCGTGCAAACCGC
CTCTACCAACCCTTACGGA -> TCTACCAACCCTTACGGAG
GAAGTGGAGGTGGCTGAGA -> AAGTGGAGGTGGCTGAGAA
GAGGAAAACGGACTTACTA -> AGGAAAACGGACTTACTAA
TCGAGAACTCCACCCAGTT -> CGAGAACTCCACCCAGTTC
AGCTTTAACCCTCTCACTC -> GCTTTAACCCTCTCACTCA
ACGTGAGGTAAGGCAATGC -> CGTGAGGTAAGGCAATGCC
ATGCGCACGCAGCAGCATT -> TGCGCACGCAGCAGCATTC
AGCGGGTTTGGTCTTTGTT -> GCGGGTTTGGTCTTTGTTT
TGTCCCCGTGTCGAGCGAT -> GTCCCCGTGTCGAGCGATG
TAGTGCCAGTTGTTTACGA -> AGTGCCAGTTGTTTACGAC
GCTTGATCCGCGCCTTCCA -> CTTGATCCGCGCCTTCCAT
AAGCGTGTAAGCAGTTCGG -> AGCGTGTAAGCAGTTCGGT
AGTGGTGACGAATGTCCGT -> GTGGTGACGAATGTCCGTA
TCTGACGAACCCATCAAAA -> CTGACGAACCCATCAAAAC
TCAAAACATGCGGGAATTT -> CAAAACATGCGGGAATTTG
TCGGTCTTTGCGTGGATTA -> CGGTCTTTGCGTGGATTAC
CGATCGTCGGTAGTCCGTA -> GATCGTCGGTAGTCCGTAC
TGAGAAGCATAACTGCCCA -> GAGAAGCATAACTGCCCAG
AATACACAGGCTGGCGAGG -> ATACACAGGCTGGCGAGGG
TTGTTTACGACCCGCAATT -> TGTTTACGACCCGCAATTA
GCGTAAACCGCGCCTTCCA -> CGTAAACCGCGCCTTCCAT
CTGAAATTAAGCATTCTCT -> TGAAATTAAGCATTCTCTA
GCTAGCAGAATTAGGGACG -> CTAGCAGAATTAGGGACGA
TTAAGCATTCTCTATGATG -> TAAGCATTCTCTATGATGC
GCCACTATGATGGCCTTGC -> CCACTATGATGGCCTTGCG
CATATCCCGCCTTACGGTA -> ATATCCCGCCTTACGGTAT
ATGACAAAACCATCGTAGA -> TGACAAAACCATCGTAGAA
CCCCTCAGCGCCGGCTGAG -> CCCTCAGCGCCGGCTGAGA
ACACTGAACTATATTTCAC -> CACTGAACTATATTTCACG
GCAAGCCGGAACTTTGTCG -> CAAGCCGGAACTTTGTCGA
TGCAGGCGCTCGGAATTAA -> GCAGGCGCTCGGAATTAAC
GGTAGTTCTCCCATCTCAG -> GTAGTTCTCCCATCTCAGT
CACGCAGCAGCATTCACGC -> ACGCAGCAGCATTCACGCC
ACAAGAAGCTGAAATTAAG -> CAAGAAGCTGAAATTAAGC
AAGCATAACTGCCCAGCTT -> AGCATAACTGCCCAGCTTT
GGAAGTGGAGGTGGCTGAG -> GAAGTGGAGGTGGCTGAGA
TTTTATAAACAGTAACCGG -> TTTATAAACAGTAACCGGA
GTCTCAAATAACTCATTAT -> TCTCAAATAACTCATTATC
TCGTCCGCTTCTACGGTTC -> CGTCCGCTTCTACGGTTCT
CATAAAGGCCGAGAGGAAA -> ATAAAGGCCGAGAGGAAAT
CTATGCGTGGGGACTTTAG -> TATGCGTGGGGACTTTAGT
GGCTAGCGTTATTCCCTAT -> GCTAGCGTTATTCCCTATT
AAAATCGAGCCGATGGTGT -> AAATCGAGCCGATGGTGTT
TATGCGCACGCAGCAGCAT -> ATGCGCACGCAGCAGCATT
GGAGTCATGTCTCGATCGT -> GAGTCATGTCTCGATCGTC
GCTCAGGGACTCTACCAAC -> CTCAGGGACTCTACCAACC
CCGGCCGCCGTGTGGTCCG -> CGGCCGCCGTGTGGTCCGC
GCAAGCCCCGAGGAAAACG -> CAAGCCCCGAGGAAAACGG
ACTGCCCAGCTTTAACCCT -> CTGCCCAGCTTTAACCCTC
ATATTTCACGGACTACGAC -> TATTTCACGGACTACGACG
CTGAAACCAAAGTTGACTG -> TGAAACCAAAGTTGACTGC
CATATCCCGCTAGAAGAGT -> ATATCCCGCTAGAAGAGTA
ATGTAAGAATTAGGTGTAT -> TGTAAGAATTAGGTGTATG
TTGAAAAGAGCCGAGTTGA -> TGAAAAGAGCCGAGTTGAC
ACAGAAATCACCCGAGGCC -> CAGAAATCACCCGAGGCCC
GAACTTTGTCGACAGAAAT -> AACTTTGTCGACAGAAATC
ACGAACATGCTAAGAGAGA -> CGAACATGCTAAGAGAGAT
CGGTCGGTCTTTGCGTGGA -> GGTCGGTCTTTGCGTGGAT
TACACAGGCTGGCGAGGGA -> ACACAGGCTGGCGAGGGAG
ATGCGGGAATTTGTGGACC -> TGCGGGAATTTGTGGACCC
CAACACACAGATTACGCCT -> AACACACAGATTACGCCTC
GGTCACAGTGGTGACGAAT -> GTCACAGTGGTGACGAATG
TGGTGTTGAAAAGAGCCGA -> GGTGTTGAAAAGAGCCGAG
CGCCTCTGCGTCTGGCCTG -> GCCTCTGCGTCTGGCCTGT
CTCGGTTTGGTTTACCCGT -> TCGGTTTGGTTTACCCGTA
CGACTGTTTCACTCACTCT -> GACTGTTTCACTCACTCTA
GTACTGTCGGCGTCGGAAG -> TACTGTCGGCGTCGGAAGT
TAATGAGATGATAGCTCGC -> AATGAGATGATAGCTCGCG
CTAGTGAGGGCTAGCGTTA -> TAGTGAGGGCTAGCGTTAT
GGGACGAGGTTCAACACAC -> GGACGAGGTTCAACACACA
CCGCCCCTATGTGTCAAGA -> CGCCCCTATGTGTCAAGAT
TAAAAATCAGTGCGCATAA -> AAAAATCAGTGCGCATAAC
ACTCTCATGCCACGGGCCA -> CTCTCATGCCACGGGCCAC
CTCGTCGGTAAACGCAGAT -> TCGTCGGTAAACGCAGATC
AGGTGTATGAATCTGGATC -> GGTGTATGAATCTGGATCA
TATGCGTGGGGACTTTAGT -> ATGCGTGGGGACTTTAGTG
GGTAGCAACGAACATGCTA -> GTAGCAACGAACATGCTAA
CGTATTGTACACACCTCGT -> GTATTGTACACACCTCGTC
AACATGCGGGAATTTGTGG -> ACATGCGGGAATTTGTGGA
CGGTATTCACTCGTGGTCA -> GGTATTCACTCGTGGTCAC
TTGGTCTTTGTTTTTTTCG -> TGGTCTTTGTTTTTTTCGC
TAAACGCAGATCTAATGGC -> AAACGCAGATCTAATGGCA
TCCGCTTCTACGGTTCTCA -> CCGCTTCTACGGTTCTCAG
GTGGGCTAATCGACAAACT -> TGGGCTAATCGACAAACTG
TTCCTGCACGACTCAAGCA -> TCCTGCACGACTCAAGCAA
GAAGCATAACTGCCCAGCT -> AAGCATAACTGCCCAGCTT
GCAAAGTGTCTCAAATAAC -> CAAAGTGTCTCAAATAACT
TCTTATCCGCCGCCCCTAT -> CTTATCCGCCGCCCCTATG
TCGAGCCGATGGTGTTGAA -> CGAGCCGATGGTGTTGAAA
GCGATGAGCTCTGCGACTG -> CGATGAGCTCTGCGACTGT
GGCTGCCATGGGAAAATCG -> GCTGCCATGGGAAAATCGA
ATCCGCGCCTTCCATATCC -> TCCGCGCCTTCCATATCCC
TGATCCGCGCCTTCCATAT -> GATCCGCGCCTTCCATATC
ATAGTACGTATTGTACACA -> TAGTACGTATTGTACACAC
CTGGCGAGGGAGGGAGCCG -> TGGCGAGGGAGGGAGCCGC
TACACAGGCTGGCACCGGC -> ACACAGGCTGGCACCGGCG
ATTAACTCTCATGCCACGG -> TTAACTCTCATGCCACGGG
AGTAAATAATTTTGTCGAT -> GTAAATAATTTTGTCGATT
ATTTTGGTAGCAACGAACA -> TTTTGGTAGCAACGAACAT
GAGGTGGCTGAGAAACTGT -> AGGTGGCTGAGAAACTGTG
TAACTGCCCAGCTTTAACC -> AACTGCCCAGCTTTAACCC
ACGTTTATCCCGGGCTGCC -> CGTTTATCCCGGGCTGCCA
TTCCGGTCGGTCTTTGCGT -> TCCGGTCGGTCTTTGCGTG
CGTGTACTGTCGGCGTCGG -> GTGTACTGTCGGCGTCGGA
TGACGAACCCATCAAAACA -> GACGAACCCATCAAAACAT
ACAGTGGTGACGAATGTCC -> CAGTGGTGACGAATGTCCG
GAGGTAAGGCAATGCCTGC -> AGGTAAGGCAATGCCTGCT
GAATGTCCGTAGAAGCGGT -> AATGTCCGTAGAAGCGGTG
TTACCCGTAGAGGCACGGC -> TACCCGTAGAGGCACGGCT
ACGTTGATTGGAGACGTCA -> CGTTGATTGGAGACGTCAC
GTCAAGATGGAACCGGTTT -> TCAAGATGGAACCGGTTTC
GCTAATGGAGTCATGTCTC -> CTAATGGAGTCATGTCTCG
GTGTTGAAAAGAGCCGAGT -> TGTTGAAAAGAGCCGAGTT
TGAAACCAAAGTTGACTGC -> GAAACCAAAGTTGACTGCG
GCCTATCGACTTCGAGAAC -> CCTATCGACTTCGAGAACT
AAAACGGACTTACTAATTC -> AAACGGACTTACTAATTCC
CGTGGGGACTTTAGTGCCA -> GTGGGGACTTTAGTGCCAG
GGGACTCTACCAACCCTTA -> GGACTCTACCAACCCTTAC
CGTGAGGTAAGGCAATGCC -> GTGAGGTAAGGCAATGCCT
GTACGGAGTCTCCAACACT -> TACGGAGTCTCCAACACTG
ACCCGAGGCCCGTGCGATC -> CCCGAGGCCCGTGCGATCG
CCGGAACTTTGTCGACAGA -> CGGAACTTTGTCGACAGAA
TACGGAGTTAAAAATCAGT -> ACGGAGTTAAAAATCAGTG
TATAAACAGTAACCGGAAA -> ATAAACAGTAACCGGAAAT
TTACGGTATTCACTCGTGG -> TACGGTATTCACTCGTGGT
GCCTAGGACGAGTAGACTG -> CCTAGGACGAGTAGACTGT
GCTGGCGAGGGAGGGAGCC -> CTGGCGAGGGAGGGAGCCG
GCGCCTTCCATATCCCGCT -> CGCCTTCCATATCCCGCTA
TGTGTGAAAGAACCGCTGT -> GTGTGAAAGAACCGCTGTG
TTCACTCACTCTATATCAG -> TCACTCACTCTATATCAGC
CGCAGTGCAAGCCCCGAGG -> GCAGTGCAAGCCCCGAGGA
TTTCGTCCGCTTCTACGGT -> TTCGTCCGCTTCTACGGTT
AGACTGTATACGGCCTCAA -> GACTGTATACGGCCTCAAT
TCCATATCCCGCAGTGACG -> CCATATCCCGCAGTGACGA
GGTAAGGCAATGCCTGCTG -> GTAAGGCAATGCCTGCTGG
CGCCGCCCCTATGTGTCAA -> GCCGCCCCTATGTGTCAAG
GCGGGCGTCCCATAACGCG -> CGGGCGTCCCATAACGCGG
AAAATCAGTGCGCATAACT -> AAATCAGTGCGCATAACTC
CCTCAATCTGACGAACCCA -> CTCAATCTGACGAACCCAT
AGATCTAATGGCAGAGAGG -> GATCTAATGGCAGAGAGGT
ATTCTTATGGCGTGGATCT -> TTCTTATGGCGTGGATCTC
GACGCTTATGCCGTGCAAA -> ACGCTTATGCCGTGCAAAC
ACCATCGTAGAACGTTGAT -> CCATCGTAGAACGTTGATT
AGTTCCTGCACGACTCAAG -> GTTCCTGCACGACTCAAGC
GTGTAAGCAGTTCGGTGAA -> TGTAAGCAGTTCGGTGAAT
AGAAGCGGTGCGGGTTACA -> GAAGCGGTGCGGGTTACAT
TAGAAGAGTAAATAATTTT -> AGAAGAGTAAATAATTTTG
CACAGGCTGGCTAATGCTT -> ACAGGCTGGCTAATGCTTG
ACGGTTGGCCAGCATAAAG -> CGGTTGGCCAGCATAAAGG
GGTCTTTGTTTTTTTCGCG -> GTCTTTGTTTTTTTCGCGG
CTACGAAGGCCTATCGACT -> TACGAAGGCCTATCGACTT
ACGCCTTCGGTCTGCAACT -> CGCCTTCGGTCTGCAACTC
ATATCCCGCAGTGACGAAT -> TATCCCGCAGTGACGAATA
ACGTCACCGGTAGCGGGTT -> CGTCACCGGTAGCGGGTTT
GCCGCCGTGTGGTCCGCGC -> CCGCCGTGTGGTCCGCGCC
CGCGGCTTAACAACGGGAA -> GCGGCTTAACAACGGGAAA
TAAGCAGTTCGGTGAATGC -> AAGCAGTTCGGTGAATGCC
CATCACAAAAGCGTGTAAG -> ATCACAAAAGCGTGTAAGC
CTCCTGGTAGTGGTCCGCC -> TCCTGGTAGTGGTCCGCCT
GACCCGCAATTAGAGTTTA -> ACCCGCAATTAGAGTTTAC
GCCATGGGAAAATCGAGCC -> CCATGGGAAAATCGAGCCG
TGTGCTCCAGTGCCTGGAG -> GTGCTCCAGTGCCTGGAGC
TCGGTAGTCCGTACGGAGT -> CGGTAGTCCGTACGGAGTC
AATTAAGCATTCTCTATGA -> ATTAAGCATTCTCTATGAT
TGAGCTCTGCGACTGTTTC -> GAGCTCTGCGACTGTTTCA
ACTGTCGGCGTCGGAAGTG -> CTGTCGGCGTCGGAAGTGG
TCCGTACGGAGTCTCCAAC -> CCGTACGGAGTCTCCAACA
ATAATCACACAGTCAGAGG -> TAATCACACAGTCAGAGGC
CAACACTGAACTATATTTC -> AACACTGAACTATATTTCA
TTGGTTTACCCGTAGAGGC -> TGGTTTACCCGTAGAGGCA
ATGCCACGGGCCACAGAAA -> TGCCACGGGCCACAGAAAC
AACCATACCCGTGGACGTG -> ACCATACCCGTGGACGTGC
CCATGGGAAAATCGAGCCG -> CATGGGAAAATCGAGCCGA
GGCCTTGCGCGCCAGGTTA -> GCCTTGCGCGCCAGGTTAC
CGAATGTCCGTAGAAGCGG -> GAATGTCCGTAGAAGCGGT
ACTTCGAGAACTCCACCCA -> CTTCGAGAACTCCACCCAG
GAGCCGAGTTGACCACAGG -> AGCCGAGTTGACCACAGGA
AGTGTGTGAAAGAACCGCT -> GTGTGTGAAAGAACCGCTG
GAGATTAACAGTGTGTTAT -> AGATTAACAGTGTGTTATA
GATCTAATGGCAGAGAGGT -> ATCTAATGGCAGAGAGGTG
CGATAATCACACAGTCAGA -> GATAATCACACAGTCAGAG
GTTGACCACAGGATGACAA -> TTGACCACAGGATGACAAA
GATGATAGCTCGCGCTAGT -> ATGATAGCTCGCGCTAGTG
CAACGGGAAATACACAGGC -> AACGGGAAATACACAGGCT
ACGCGGCAGAACCTCCCCG -> CGCGGCAGAACCTCCCCGT
GTGTTATAATGACGATAAT -> TGTTATAATGACGATAATC
TCCCGGCCGCCGTGTGGTC -> CCCGGCCGCCGTGTGGTCC
ACGACTCAAGCAAGCCGGA -> CGACTCAAGCAAGCCGGAA
TCGATTCGATATGTCTGAG -> CGATTCGATATGTCTGAGG
TATTCACTCGTGGTCACAG -> ATTCACTCGTGGTCACAGT
GTAGCTACCGGTGGGCTAA -> TAGCTACCGGTGGGCTAAT
CGAATAGTACGTATTGTAC -> GAATAGTACGTATTGTACA
TTGCAGGCGCTCGGAATTA -> TGCAGGCGCTCGGAATTAA
AATAACTCATTATCAGCTC -> ATAACTCATTATCAGCTCA
CCTTCCATATCCCGGCCGC -> CTTCCATATCCCGGCCGCC
GTATGAGTATTTTGCAGGA -> TATGAGTATTTTGCAGGAG
AGCAACGAACATGCTAAGA -> GCAACGAACATGCTAAGAG
AACACACAGATTACGCCTC -> ACACACAGATTACGCCTCT
TCAAGCAAGCCGGAACTTT -> CAAGCAAGCCGGAACTTTG
ACTCTATATCAGCGCTCTA -> CTCTATATCAGCGCTCTAC
CAAACCGCAGTGCAAGCCC -> AAACCGCAGTGCAAGCCCC
AACAGTAACCGGAAATACA -> ACAGTAACCGGAAATACAC
CAGGCGCTCGGAATTAACT -> AGGCGCTCGGAATTAACTC
TATGATGCTAATGGAGTCA -> ATGATGCTAATGGAGTCAT
AATCAGTGCGCATAACTCT -> ATCAGTGCGCATAACTCTA
TACTAATTCCGGTCGGTCT -> ACTAATTCCGGTCGGTCTT
GTAAACGCAGATCTAATGG -> TAAACGCAGATCTAATGGC
TACGACCCGCAATTAGAGT -> ACGACCCGCAATTAGAGTT
TGGCACACTTCTTGAGATT -> GGCACACTTCTTGAGATTA
GAATAGTACGTATTGTACA -> AATAGTACGTATTGTACAC
GTTCGGTGAATGCCACTAT -> TTCGGTGAATGCCACTATG
GGAATTAACTCTCATGCCA -> GAATTAACTCTCATGCCAC
TCCGGTCGGTCTTTGCGTG -> CCGGTCGGTCTTTGCGTGG
TGCCATGGGAAAATCGAGC -> GCCATGGGAAAATCGAGCC
GGCCGCCGTGTGGTCCGCG -> GCCGCCGTGTGGTCCGCGC
TGGCCTGTATGTTAAGGTC -> GGCCTGTATGTTAAGGTCC
TCAGACGCTTATGCCGTGC -> CAGACGCTTATGCCGTGCA
CGTTTATCCCGGGCTGCCA -> GTTTATCCCGGGCTGCCAT
AAGGCCTATCGACTTCGAG -> AGGCCTATCGACTTCGAGA
CTGTCGGCGTCGGAAGTGG -> TGTCGGCGTCGGAAGTGGA
TACCCGTGGACGTGCCTAG -> ACCCGTGGACGTGCCTAGG
GCGGGTTTGGTCTTTGTTT -> CGGGTTTGGTCTTTGTTTT
CGGTAGTCCGTACGGAGTC -> GGTAGTCCGTACGGAGTCT
TGGTAGCTACCGGTGGGCT -> GGTAGCTACCGGTGGGCTA
TACGCACACTCAGTCGATT -> ACGCACACTCAGTCGATTC
TGGCCAGCATAAAGGCCGA -> GGCCAGCATAAAGGCCGAG
GACTCTACCAACCCTTACG -> ACTCTACCAACCCTTACGG
AAGAGTAAATAATTTTGTC -> AGAGTAAATAATTTTGTCG
TCGGTCTGCAACTCCTGGT -> CGGTCTGCAACTCCTGGTA
CAGCATTCACGCCTTCGGT -> AGCATTCACGCCTTCGGTC
ACGCACACTCAGTCGATTC -> CGCACACTCAGTCGATTCG
ATCGGTGGTCGCTCGGTTT -> TCGGTGGTCGCTCGGTTTG
TGTTTCACTCACTCTATAT -> GTTTCACTCACTCTATATC
CGGCTTAACAACGGGAAAT -> GGCTTAACAACGGGAAATA
TGCACCGTCCCTGAAATTG -> GCACCGTCCCTGAAATTGG
AACAGTGTGTTATAATGAC -> ACAGTGTGTTATAATGACG
CCATCAAAACATGCGGGAA -> CATCAAAACATGCGGGAAT
ACTGTGCTCCAGTGCCTGG -> CTGTGCTCCAGTGCCTGGA
GCAGCAGCATTCACGCCTT -> CAGCAGCATTCACGCCTTC
CTGGTATGAGTATTTTGCA -> TGGTATGAGTATTTTGCAG
CTAGGGTTCAAAGGCAGTA -> TAGGGTTCAAAGGCAGTAA
ATGCACCGTCCCTGAAATT -> TGCACCGTCCCTGAAATTG
AGCTCTGCGACTGTTTCAC -> GCTCTGCGACTGTTTCACT
GTCACCGGTAGCGGGTTTG -> TCACCGGTAGCGGGTTTGG
GTCACAGTGGTGACGAATG -> TCACAGTGGTGACGAATGT
ACCCGTGGACGTGCCTAGG -> CCCGTGGACGTGCCTAGGA
GCCACTACGAAGGCCTATC -> CCACTACGAAGGCCTATCG
CTTCGGTCTGCAACTCCTG -> TTCGGTCTGCAACTCCTGG
CGGGCCACAGAAACGGTTG -> GGGCCACAGAAACGGTTGG
GCTTAACAACGGGAAATAC -> CTTAACAACGGGAAATACA
CGTCGGAAGTGGAGGTGGC -> GTCGGAAGTGGAGGTGGCT
TAGTTCTCCCATCTCAGTC -> AGTTCTCCCATCTCAGTCT
ACATTCTTATGGCGTGGAT -> CATTCTTATGGCGTGGATC
AAGCAGCAGGTCGCTTGGT -> AGCAGCAGGTCGCTTGGTA
CCTCGTCTGGGTAGTTCTC -> CTCGTCTGGGTAGTTCTCC
TTTATACCATCACAAAAGC -> TTATACCATCACAAAAGCG
GCGCGCCAGGTTACGTTTA -> CGCGCCAGGTTACGTTTAT
CCCGGGCTGCCATGGGAAA -> CCGGGCTGCCATGGGAAAA
GACCACAGGATGACAAAAC -> ACCACAGGATGACAAAACC
TGTCGAGCGATGAGCTCTG -> GTCGAGCGATGAGCTCTGC
GACGAACCCATCAAAACAT -> ACGAACCCATCAAAACATG
