AGTAACGAGAA -> GTAACGAGAAC
GTAACGAGAAC -> TAACGAGAACG
TAACGAGAACG -> AACGAGAACGT
AACGAGAACGT -> ACGAGAACGTG
ACGAGAACGTG -> CGAGAACGTGA
CGAGAACGTGA -> GAGAACGTGAG
GAGAACGTGAG -> AGAACGTGAGA
AGAACGTGAGA -> GAACGTGAGAG
GAACGTGAGAG -> AACGTGAGAGT
AACGTGAGAGT -> ACGTGAGAGTG
ACGTGAGAGTG -> CGTGAGAGTGT
CGTGAGAGTGT -> GTGAGAGTGTA
GTGAGAGTGTA -> TGAGAGTGTAC
TGAGAGTGTAC -> GAGAGTGTACT
GAGAGTGTACT -> AGAGTGTACTT
AGAGTGTACTT -> GAGTGTACTTA
GAGTGTACTTA -> AGTGTACTTAC
AGTGTACTTAC -> GTGTACTTACC
GTGTACTTACC -> TGTACTTACCT
TGTACTTACCT -> GTACTTACCTA
GTACTTACCTA -> TACTTACCTAC
TACTTACCTAC -> ACTTACCTACC
ACTTACCTACC -> CTTACCTACCT
CTTACCTACCT -> TTACCTACCTG
TTACCTACCTG -> TACCTACCTGG
TACCTACCTGG -> ACCTACCTGGA
ACCTACCTGGA -> CCTACCTGGAC
CCTACCTGGAC -> CTACCTGGACC
CTACCTGGACC -> TACCTGGACCT
TACCTGGACCT -> ACCTGGACCTG
ACCTGGACCTG -> CCTGGACCTGG
CCTGGACCTGG -> CTGGACCTGGT
CTGGACCTGGT -> TGGACCTGGTT
TGGACCTGGTT -> GGACCTGGTTA
GGACCTGGTTA -> GACCTGGTTAT
GACCTGGTTAT -> ACCTGGTTATG
ACCTGGTTATG -> CCTGGTTATGC
CCTGGTTATGC -> CTGGTTATGCT
CTGGTTATGCT -> TGGTTATGCTT
TGGTTATGCTT -> GGTTATGCTTT
GGTTATGCTTT -> GTTATGCTTTG
GTTATGCTTTG -> TTATGCTTTGG
TTATGCTTTGG -> TATGCTTTGGG
TATGCTTTGGG -> ATGCTTTGGGT
ATGCTTTGGGT -> TGCTTTGGGTA
TGCTTTGGGTA -> GCTTTGGGTAT
GCTTTGGGTAT -> CTTTGGGTATA
CTTTGGGTATA -> TTTGGGTATAT
TTTGGGTATAT -> TTGGGTATATC
TTGGGTATATC -> TGGGTATATCG
TGGGTATATCG -> GGGTATATCGG
GGGTATATCGG -> GGTATATCGGA
GGTATATCGGA -> GTATATCGGAG
GTATATCGGAG -> TATATCGGAGT
TATATCGGAGT -> ATATCGGAGTT
ATATCGGAGTT -> TATCGGAGTTA
TATCGGAGTTA -> ATCGGAGTTAC
ATCGGAGTTAC -> TCGGAGTTACA
TCGGAGTTACA -> CGGAGTTACAG
CGGAGTTACAG -> GGAGTTACAGA
GGAGTTACAGA -> GAGTTACAGAG
GAGTTACAGAG -> AGTTACAGAGA
AGTTACAGAGA -> GTTACAGAGAC
GTTACAGAGAC -> TTACAGAGACA
TTACAGAGACA -> TACAGAGACAT
TACAGAGACAT -> ACAGAGACATA
ACAGAGACATA -> CAGAGACATAA
CAGAGACATAA -> AGAGACATAAA
AGAGACATAAA -> GAGACATAAAT
GAGACATAAAT -> AGACATAAATC
AGACATAAATC -> GACATAAATCG
GACATAAATCG -> ACATAAATCGA
ACATAAATCGA -> CATAAATCGAA
CATAAATCGAA -> ATAAATCGAAC
ATAAATCGAAC -> TAAATCGAACG
TAAATCGAACG -> AAATCGAACGC
AAATCGAACGC -> AATCGAACGCA
AATCGAACGCA -> ATCGAACGCAC
ATCGAACGCAC -> TCGAACGCACA
TCGAACGCACA -> CGAACGCACAC
CGAACGCACAC -> GAACGCACACC
GAACGCACACC -> AACGCACACCG
AACGCACACCG -> ACGCACACCGC
ACGCACACCGC -> CGCACACCGCG
CGCACACCGCG -> GCACACCGCGA
GCACACCGCGA -> CACACCGCGAT
CACACCGCGAT -> ACACCGCGATT
ACACCGCGATT -> CACCGCGATTA
CACCGCGATTA -> ACCGCGATTAG
ACCGCGATTAG -> CCGCGATTAGA
CCGCGATTAGA -> CGCGATTAGAC
CGCGATTAGAC -> GCGATTAGACC
GCGATTAGACC -> CGATTAGACCA
CGATTAGACCA -> GATTAGACCAT
GATTAGACCAT -> ATTAGACCATC
ATTAGACCATC -> TTAGACCATCA
TTAGACCATCA -> TAGACCATCAC
TAGACCATCAC -> AGACCATCACA
AGACCATCACA -> GACCATCACAG
GACCATCACAG -> ACCATCACAGA
ACCATCACAGA -> CCATCACAGAT
CCATCACAGAT -> CATCACAGATC
CATCACAGATC -> ATCACAGATCA
ATCACAGATCA -> TCACAGATCAA
TCACAGATCAA -> CACAGATCAAT
CACAGATCAAT -> ACAGATCAATA
ACAGATCAATA -> CAGATCAATAT
CAGATCAATAT -> AGATCAATATT
AGATCAATATT -> GATCAATATTG
GATCAATATTG -> ATCAATATTGG
ATCAATATTGG -> TCAATATTGGT
TCAATATTGGT -> CAATATTGGTT
CAATATTGGTT -> AATATTGGTTA
AATATTGGTTA -> ATATTGGTTAA
ATATTGGTTAA -> TATTGGTTAAG
TATTGGTTAAG -> ATTGGTTAAGC
ATTGGTTAAGC -> TTGGTTAAGCT
TTGGTTAAGCT -> TGGTTAAGCTG
TGGTTAAGCTG -> GGTTAAGCTGA
GGTTAAGCTGA -> GTTAAGCTGAA
GTTAAGCTGAA -> TTAAGCTGAAG
TTAAGCTGAAG -> TAAGCTGAAGC
TAAGCTGAAGC -> AAGCTGAAGCT
AAGCTGAAGCT -> AGCTGAAGCTA
AGCTGAAGCTA -> GCTGAAGCTAA
GCTGAAGCTAA -> CTGAAGCTAAC
CTGAAGCTAAC -> TGAAGCTAACA
TGAAGCTAACA -> GAAGCTAACAC
GAAGCTAACAC -> AAGCTAACACA
AAGCTAACACA -> AGCTAACACAG
AGCTAACACAG -> GCTAACACAGC
GCTAACACAGC -> CTAACACAGCC
CTAACACAGCC -> TAACACAGCCA
TAACACAGCCA -> AACACAGCCAG
AACACAGCCAG -> ACACAGCCAGC
ACACAGCCAGC -> CACAGCCAGCC
CACAGCCAGCC -> ACAGCCAGCCG
ACAGCCAGCCG -> CAGCCAGCCGT
CAGCCAGCCGT -> AGCCAGCCGTT
AGCCAGCCGTT -> GCCAGCCGTTC
GCCAGCCGTTC -> CCAGCCGTTCG
CCAGCCGTTCG -> CAGCCGTTCGA
CAGCCGTTCGA -> AGCCGTTCGAA
AGCCGTTCGAA -> GCCGTTCGAAG
GCCGTTCGAAG -> CCGTTCGAAGT
CCGTTCGAAGT -> CGTTCGAAGTT
CGTTCGAAGTT -> GTTCGAAGTTG
GTTCGAAGTTG -> TTCGAAGTTGC
TTCGAAGTTGC -> TCGAAGTTGCG
TCGAAGTTGCG -> CGAAGTTGCGC
CGAAGTTGCGC -> GAAGTTGCGCG
GAAGTTGCGCG -> AAGTTGCGCGG
AAGTTGCGCGG -> AGTTGCGCGGG
AGTTGCGCGGG -> GTTGCGCGGGA
GTTGCGCGGGA -> TTGCGCGGGAG
TTGCGCGGGAG -> TGCGCGGGAGA
TGCGCGGGAGA -> GCGCGGGAGAT
GCGCGGGAGAT -> CGCGGGAGATC
CGCGGGAGATC -> GCGGGAGATCC
GCGGGAGATCC -> CGGGAGATCCG
CGGGAGATCCG -> GGGAGATCCGC
GGGAGATCCGC -> GGAGATCCGCG
GGAGATCCGCG -> GAGATCCGCGT
GAGATCCGCGT -> AGATCCGCGTA
AGATCCGCGTA -> GATCCGCGTAG
GATCCGCGTAG -> ATCCGCGTAGT
ATCCGCGTAGT -> TCCGCGTAGTG
TCCGCGTAGTG -> CCGCGTAGTGG
CCGCGTAGTGG -> CGCGTAGTGGA
CGCGTAGTGGA -> GCGTAGTGGAC
GCGTAGTGGAC -> CGTAGTGGACA
CGTAGTGGACA -> GTAGTGGACAC
GTAGTGGACAC -> TAGTGGACACC
TAGTGGACACC -> AGTGGACACCG
AGTGGACACCG -> GTGGACACCGC
GTGGACACCGC -> TGGACACCGCT
TGGACACCGCT -> GGACACCGCTT
GGACACCGCTT -> GACACCGCTTC
GACACCGCTTC -> ACACCGCTTCA
ACACCGCTTCA -> CACCGCTTCAC
CACCGCTTCAC -> ACCGCTTCACT
ACCGCTTCACT -> CCGCTTCACTC
CCGCTTCACTC -> CGCTTCACTCA
CGCTTCACTCA -> GCTTCACTCAC
GCTTCACTCAC -> CTTCACTCACA
CTTCACTCACA -> TTCACTCACAA
TTCACTCACAA -> TCACTCACAAA
TCACTCACAAA -> CACTCACAAAA
CACTCACAAAA -> ACTCACAAAAA
ACTCACAAAAA -> CTCACAAAAAC
CTCACAAAAAC -> TCACAAAAACA
TCACAAAAACA -> CACAAAAACAC
CACAAAAACAC -> ACAAAAACACA
ACAAAAACACA -> CAAAAACACAG
CAAAAACACAG -> AAAAACACAGT
AAAAACACAGT -> AAAACACAGTC
AAAACACAGTC -> AAACACAGTCG
AAACACAGTCG -> AACACAGTCGG
AACACAGTCGG -> ACACAGTCGGT
ACACAGTCGGT -> CACAGTCGGTA
CACAGTCGGTA -> ACAGTCGGTAT
ACAGTCGGTAT -> CAGTCGGTATT
CAGTCGGTATT -> AGTCGGTATTA
AGTCGGTATTA -> GTCGGTATTAG
GTCGGTATTAG -> TCGGTATTAGG
TCGGTATTAGG -> CGGTATTAGGA
CGGTATTAGGA -> GGTATTAGGAT
GGTATTAGGAT -> GTATTAGGATG
GTATTAGGATG -> TATTAGGATGT
TATTAGGATGT -> ATTAGGATGTT
ATTAGGATGTT -> TTAGGATGTTG
TTAGGATGTTG -> TAGGATGTTGT
TAGGATGTTGT -> AGGATGTTGTC
AGGATGTTGTC -> GGATGTTGTCA
GGATGTTGTCA -> GATGTTGTCAG
GATGTTGTCAG -> ATGTTGTCAGG
ATGTTGTCAGG -> TGTTGTCAGGG
TGTTGTCAGGG -> GTTGTCAGGGG
GTTGTCAGGGG -> TTGTCAGGGGC
TTGTCAGGGGC -> TGTCAGGGGCC
TGTCAGGGGCC -> GTCAGGGGCCT
GTCAGGGGCCT -> TCAGGGGCCTC
TCAGGGGCCTC -> CAGGGGCCTCT
CAGGGGCCTCT -> AGGGGCCTCTT
AGGGGCCTCTT -> GGGGCCTCTTA
GGGGCCTCTTA -> GGGCCTCTTAA
GGGCCTCTTAA -> GGCCTCTTAAT
GGCCTCTTAAT -> GCCTCTTAATG
GCCTCTTAATG -> CCTCTTAATGC
CCTCTTAATGC -> CTCTTAATGCG
CTCTTAATGCG -> TCTTAATGCGA
TCTTAATGCGA -> CTTAATGCGAC
CTTAATGCGAC -> TTAATGCGACC
TTAATGCGACC -> TAATGCGACCC
TAATGCGACCC -> AATGCGACCCA
AATGCGACCCA -> ATGCGACCCAT
ATGCGACCCAT -> TGCGACCCATA
TGCGACCCATA -> GCGACCCATAG
GCGACCCATAG -> CGACCCATAGG
CGACCCATAGG -> GACCCATAGGG
GACCCATAGGG -> ACCCATAGGGA
ACCCATAGGGA -> CCCATAGGGAC
CCCATAGGGAC -> CCATAGGGACC
CCATAGGGACC -> CATAGGGACCA
CATAGGGACCA -> ATAGGGACCAT
ATAGGGACCAT -> TAGGGACCATC
TAGGGACCATC -> AGGGACCATCA
AGGGACCATCA -> GGGACCATCAG
GGGACCATCAG -> GGACCATCAGA
GGACCATCAGA -> GACCATCAGAT
GACCATCAGAT -> ACCATCAGATC
ACCATCAGATC -> CCATCAGATCT
CCATCAGATCT -> CATCAGATCTG
CATCAGATCTG -> ATCAGATCTGG
ATCAGATCTGG -> TCAGATCTGGT
TCAGATCTGGT -> CAGATCTGGTT
CAGATCTGGTT -> AGATCTGGTTA
AGATCTGGTTA -> GATCTGGTTAA
GATCTGGTTAA -> ATCTGGTTAAA
ATCTGGTTAAA -> TCTGGTTAAAT
TCTGGTTAAAT -> CTGGTTAAATT
CTGGTTAAATT -> TGGTTAAATTA
TGGTTAAATTA -> GGTTAAATTAC
GGTTAAATTAC -> GTTAAATTACA
GTTAAATTACA -> TTAAATTACAA
TTAAATTACAA -> TAAATTACAAA
TAAATTACAAA -> AAATTACAAAT
AAATTACAAAT -> AATTACAAATG
AATTACAAATG -> ATTACAAATGC
ATTACAAATGC -> TTACAAATGCA
TTACAAATGCA -> TACAAATGCAA
TACAAATGCAA -> ACAAATGCAAT
ACAAATGCAAT -> CAAATGCAATC
CAAATGCAATC -> AAATGCAATCA
AAATGCAATCA -> AATGCAATCAA
AATGCAATCAA -> ATGCAATCAAG
ATGCAATCAAG -> TGCAATCAAGT
TGCAATCAAGT -> GCAATCAAGTT
GCAATCAAGTT -> CAATCAAGTTA
CAATCAAGTTA -> AATCAAGTTAA
AATCAAGTTAA -> ATCAAGTTAAG
ATCAAGTTAAG -> TCAAGTTAAGC
TCAAGTTAAGC -> CAAGTTAAGCC
CAAGTTAAGCC -> AAGTTAAGCCA
AAGTTAAGCCA -> AGTTAAGCCAG
AGTTAAGCCAG -> GTTAAGCCAGT
GTTAAGCCAGT -> TTAAGCCAGTG
TTAAGCCAGTG -> TAAGCCAGTGT
TAAGCCAGTGT -> AAGCCAGTGTC
AAGCCAGTGTC -> AGCCAGTGTCC
AGCCAGTGTCC -> GCCAGTGTCCG
GCCAGTGTCCG -> CCAGTGTCCGG
CCAGTGTCCGG -> CAGTGTCCGGG
CAGTGTCCGGG -> AGTGTCCGGGA
AGTGTCCGGGA -> GTGTCCGGGAG
GTGTCCGGGAG -> TGTCCGGGAGT
TGTCCGGGAGT -> GTCCGGGAGTG
GTCCGGGAGTG -> TCCGGGAGTGT
TCCGGGAGTGT -> CCGGGAGTGTA
CCGGGAGTGTA -> CGGGAGTGTAC
CGGGAGTGTAC -> GGGAGTGTACA
GGGAGTGTACA -> GGAGTGTACAT
GGAGTGTACAT -> GAGTGTACATC
GAGTGTACATC -> AGTGTACATCC
AGTGTACATCC -> GTGTACATCCA
GTGTACATCCA -> TGTACATCCAC
TGTACATCCAC -> GTACATCCACT
GTACATCCACT -> TACATCCACTT
TACATCCACTT -> ACATCCACTTA
ACATCCACTTA -> CATCCACTTAT
CATCCACTTAT -> ATCCACTTATG
ATCCACTTATG -> TCCACTTATGA
TCCACTTATGA -> CCACTTATGAA
CCACTTATGAA -> CACTTATGAAG
CACTTATGAAG -> ACTTATGAAGA
ACTTATGAAGA -> CTTATGAAGAT
CTTATGAAGAT -> TTATGAAGATC
TTATGAAGATC -> TATGAAGATCC
TATGAAGATCC -> ATGAAGATCCA
ATGAAGATCCA -> TGAAGATCCAT
TGAAGATCCAT -> GAAGATCCATC
GAAGATCCATC -> AAGATCCATCT
AAGATCCATCT -> AGATCCATCTG
AGATCCATCTG -> GATCCATCTGT
GATCCATCTGT -> ATCCATCTGTC
ATCCATCTGTC -> TCCATCTGTCT
TCCATCTGTCT -> CCATCTGTCTG
CCATCTGTCTG -> CATCTGTCTGG
CATCTGTCTGG -> ATCTGTCTGGA
ATCTGTCTGGA -> TCTGTCTGGAC
TCTGTCTGGAC -> CTGTCTGGACT
CTGTCTGGACT -> TGTCTGGACTC
TGTCTGGACTC -> GTCTGGACTCT
GTCTGGACTCT -> TCTGGACTCTC
TCTGGACTCTC -> CTGGACTCTCA
CTGGACTCTCA -> TGGACTCTCAT
TGGACTCTCAT -> GGACTCTCATT
GGACTCTCATT -> GACTCTCATTT
GACTCTCATTT -> ACTCTCATTTC
ACTCTCATTTC -> CTCTCATTTCG
CTCTCATTTCG -> TCTCATTTCGA
TCTCATTTCGA -> CTCATTTCGAC
CTCATTTCGAC -> TCATTTCGACC
TCATTTCGACC -> CATTTCGACCG
CATTTCGACCG -> ATTTCGACCGT
ATTTCGACCGT -> TTTCGACCGTC
TTTCGACCGTC -> TTCGACCGTCG
TTCGACCGTCG -> TCGACCGTCGG
TCGACCGTCGG -> CGACCGTCGGT
CGACCGTCGGT -> GACCGTCGGTA
GACCGTCGGTA -> ACCGTCGGTAG
ACCGTCGGTAG -> CCGTCGGTAGG
CCGTCGGTAGG -> CGTCGGTAGGC
CGTCGGTAGGC -> GTCGGTAGGCC
GTCGGTAGGCC -> TCGGTAGGCCG
TCGGTAGGCCG -> CGGTAGGCCGG
CGGTAGGCCGG -> GGTAGGCCGGC
GGTAGGCCGGC -> GTAGGCCGGCG
GTAGGCCGGCG -> TAGGCCGGCGG
TAGGCCGGCGG -> AGGCCGGCGGG
AGGCCGGCGGG -> GGCCGGCGGGC
GGCCGGCGGGC -> GCCGGCGGGCG
GCCGGCGGGCG -> CCGGCGGGCGG
CCGGCGGGCGG -> CGGCGGGCGGA
CGGCGGGCGGA -> GGCGGGCGGAT
GGCGGGCGGAT -> GCGGGCGGATA
GCGGGCGGATA -> CGGGCGGATAC
CGGGCGGATAC -> GGGCGGATACG
GGGCGGATACG -> GGCGGATACGC
GGCGGATACGC -> GCGGATACGCG
GCGGATACGCG -> CGGATACGCGC
CGGATACGCGC -> GGATACGCGCA
GGATACGCGCA -> GATACGCGCAT
GATACGCGCAT -> ATACGCGCATA
ATACGCGCATA -> TACGCGCATAT
TACGCGCATAT -> ACGCGCATATC
ACGCGCATATC -> CGCGCATATCT
CGCGCATATCT -> GCGCATATCTT
GCGCATATCTT -> CGCATATCTTG
CGCATATCTTG -> GCATATCTTGC
GCATATCTTGC -> CATATCTTGCT
CATATCTTGCT -> ATATCTTGCTC
ATATCTTGCTC -> TATCTTGCTCG
TATCTTGCTCG -> ATCTTGCTCGT
ATCTTGCTCGT -> TCTTGCTCGTT
TCTTGCTCGTT -> CTTGCTCGTTG
CTTGCTCGTTG -> TTGCTCGTTGT
TTGCTCGTTGT -> TGCTCGTTGTC
TGCTCGTTGTC -> GCTCGTTGTCC
GCTCGTTGTCC -> CTCGTTGTCCT
CTCGTTGTCCT -> TCGTTGTCCTG
TCGTTGTCCTG -> CGTTGTCCTGA
CGTTGTCCTGA -> GTTGTCCTGAG
GTTGTCCTGAG -> TTGTCCTGAGT
TTGTCCTGAGT -> TGTCCTGAGTC
TGTCCTGAGTC -> GTCCTGAGTCG
GTCCTGAGTCG -> TCCTGAGTCGT
TCCTGAGTCGT -> CCTGAGTCGTA
CCTGAGTCGTA -> CTGAGTCGTAC
CTGAGTCGTAC -> TGAGTCGTACC
TGAGTCGTACC -> GAGTCGTACCA
GAGTCGTACCA -> AGTCGTACCAG, AGTCGTACCAC
AGTCGTACCAG -> GTCGTACCAGT
GTCGTACCAGT -> TCGTACCAGTA
TCGTACCAGTA -> CGTACCAGTAG
CGTACCAGTAG -> GTACCAGTAGT
GTACCAGTAGT -> TACCAGTAGTG
TACCAGTAGTG -> ACCAGTAGTGC
ACCAGTAGTGC -> CCAGTAGTGCG
CCAGTAGTGCG -> CAGTAGTGCGG
CAGTAGTGCGG -> AGTAGTGCGGC
AGTAGTGCGGC -> GTAGTGCGGCT
GTAGTGCGGCT -> TAGTGCGGCTC
TAGTGCGGCTC -> AGTGCGGCTCT
AGTGCGGCTCT -> GTGCGGCTCTA
GTGCGGCTCTA -> TGCGGCTCTAT
TGCGGCTCTAT -> GCGGCTCTATA
GCGGCTCTATA -> CGGCTCTATAT
CGGCTCTATAT -> GGCTCTATATG
GGCTCTATATG -> GCTCTATATGT
GCTCTATATGT -> CTCTATATGTG
CTCTATATGTG -> TCTATATGTGA
TCTATATGTGA -> CTATATGTGAT
CTATATGTGAT -> TATATGTGATC
TATATGTGATC -> ATATGTGATCA
ATATGTGATCA -> TATGTGATCAT
TATGTGATCAT -> ATGTGATCATC
ATGTGATCATC -> TGTGATCATCT
TGTGATCATCT -> GTGATCATCTG
GTGATCATCTG -> TGATCATCTGC
TGATCATCTGC -> GATCATCTGCA
GATCATCTGCA -> ATCATCTGCAC
ATCATCTGCAC -> TCATCTGCACC
TCATCTGCACC -> CATCTGCACCT
CATCTGCACCT -> ATCTGCACCTC
ATCTGCACCTC -> TCTGCACCTCT
TCTGCACCTCT -> CTGCACCTCTG
CTGCACCTCTG -> TGCACCTCTGG
TGCACCTCTGG -> GCACCTCTGGC
GCACCTCTGGC -> CACCTCTGGCG
CACCTCTGGCG -> ACCTCTGGCGG
ACCTCTGGCGG -> CCTCTGGCGGC
CCTCTGGCGGC -> CTCTGGCGGCA
CTCTGGCGGCA -> TCTGGCGGCAC
TCTGGCGGCAC -> CTGGCGGCACC
CTGGCGGCACC -> TGGCGGCACCT
TGGCGGCACCT -> GGCGGCACCTC
GGCGGCACCTC -> GCGGCACCTCA
GCGGCACCTCA -> CGGCACCTCAG
CGGCACCTCAG -> GGCACCTCAGA
GGCACCTCAGA -> GCACCTCAGAT
GCACCTCAGAT -> CACCTCAGATA
CACCTCAGATA -> ACCTCAGATAT
ACCTCAGATAT -> CCTCAGATATC
CCTCAGATATC -> CTCAGATATCA
CTCAGATATCA -> TCAGATATCAA
TCAGATATCAA -> CAGATATCAAA
CAGATATCAAA -> AGATATCAAAC
AGATATCAAAC -> GATATCAAACG
GATATCAAACG -> ATATCAAACGA
ATATCAAACGA -> TATCAAACGAG
TATCAAACGAG -> ATCAAACGAGC
ATCAAACGAGC -> TCAAACGAGCA
TCAAACGAGCA -> CAAACGAGCAG
CAAACGAGCAG -> AAACGAGCAGA
AAACGAGCAGA -> AACGAGCAGAG
AACGAGCAGAG -> ACGAGCAGAGC
ACGAGCAGAGC -> CGAGCAGAGCA
CGAGCAGAGCA -> GAGCAGAGCAC
GAGCAGAGCAC -> AGCAGAGCACT
AGCAGAGCACT -> GCAGAGCACTT
GCAGAGCACTT -> CAGAGCACTTA
CAGAGCACTTA -> AGAGCACTTAC
AGAGCACTTAC -> GAGCACTTACT
GAGCACTTACT -> AGCACTTACTA
AGCACTTACTA -> GCACTTACTAA
GCACTTACTAA -> CACTTACTAAT
CACTTACTAAT -> ACTTACTAATT
ACTTACTAATT -> CTTACTAATTA
CTTACTAATTA -> TTACTAATTAG
TTACTAATTAG -> TACTAATTAGA
TACTAATTAGA -> ACTAATTAGAG
ACTAATTAGAG -> CTAATTAGAGG
CTAATTAGAGG -> TAATTAGAGGA
TAATTAGAGGA -> AATTAGAGGAT
AATTAGAGGAT -> ATTAGAGGATA
ATTAGAGGATA -> TTAGAGGATAA
TTAGAGGATAA -> TAGAGGATAAC
TAGAGGATAAC -> AGAGGATAACG
AGAGGATAACG -> GAGGATAACGT
GAGGATAACGT -> AGGATAACGTT
AGGATAACGTT -> GGATAACGTTA
GGATAACGTTA -> GATAACGTTAG
GATAACGTTAG -> ATAACGTTAGA
ATAACGTTAGA -> TAACGTTAGAC
TAACGTTAGAC -> AACGTTAGACT
AACGTTAGACT -> ACGTTAGACTG
ACGTTAGACTG -> CGTTAGACTGC
CGTTAGACTGC -> GTTAGACTGCA
GTTAGACTGCA -> TTAGACTGCAG
TTAGACTGCAG -> TAGACTGCAGC
TAGACTGCAGC -> AGACTGCAGCG
AGACTGCAGCG -> GACTGCAGCGT
GACTGCAGCGT -> ACTGCAGCGTA
ACTGCAGCGTA -> CTGCAGCGTAC
CTGCAGCGTAC -> TGCAGCGTACG
TGCAGCGTACG -> GCAGCGTACGT
GCAGCGTACGT -> CAGCGTACGTT
CAGCGTACGTT -> AGCGTACGTTT
AGCGTACGTTT -> GCGTACGTTTC
GCGTACGTTTC -> CGTACGTTTCG
CGTACGTTTCG -> GTACGTTTCGA
GTACGTTTCGA -> TACGTTTCGAC
TACGTTTCGAC -> ACGTTTCGACC
ACGTTTCGACC -> CGTTTCGACCT
CGTTTCGACCT -> GTTTCGACCTA
GTTTCGACCTA -> TTTCGACCTAG
TTTCGACCTAG -> TTCGACCTAGA
TTCGACCTAGA -> TCGACCTAGAG
TCGACCTAGAG -> CGACCTAGAGG
CGACCTAGAGG -> GACCTAGAGGT
GACCTAGAGGT -> ACCTAGAGGTA
ACCTAGAGGTA -> CCTAGAGGTAC
CCTAGAGGTAC -> CTAGAGGTACG
CTAGAGGTACG -> TAGAGGTACGA
TAGAGGTACGA -> AGAGGTACGAT
AGAGGTACGAT -> GAGGTACGATG
GAGGTACGATG -> AGGTACGATGG
AGGTACGATGG -> GGTACGATGGT
GGTACGATGGT -> GTACGATGGTG
GTACGATGGTG -> TACGATGGTGA
TACGATGGTGA -> ACGATGGTGAT
ACGATGGTGAT -> CGATGGTGATA, CGATGGTGATG
CGATGGTGATA -> GATGGTGATAA
GATGGTGATAA -> ATGGTGATAAG
ATGGTGATAAG -> TGGTGATAAGG
TGGTGATAAGG -> GGTGATAAGGC
GGTGATAAGGC -> GTGATAAGGCC
GTGATAAGGCC -> TGATAAGGCCA
TGATAAGGCCA -> GATAAGGCCAC
GATAAGGCCAC -> ATAAGGCCACC
ATAAGGCCACC -> TAAGGCCACCT
TAAGGCCACCT -> AAGGCCACCTA
AAGGCCACCTA -> AGGCCACCTAT
AGGCCACCTAT -> GGCCACCTATG
GGCCACCTATG -> GCCACCTATGA
GCCACCTATGA -> CCACCTATGAT
CCACCTATGAT -> CACCTATGATT
CACCTATGATT -> ACCTATGATTT
ACCTATGATTT -> CCTATGATTTA
CCTATGATTTA -> CTATGATTTAT
CTATGATTTAT -> TATGATTTATA
TATGATTTATA -> ATGATTTATAC
ATGATTTATAC -> TGATTTATACA
TGATTTATACA -> GATTTATACAC
GATTTATACAC -> ATTTATACACC
ATTTATACACC -> TTTATACACCA
TTTATACACCA -> TTATACACCAC
TTATACACCAC -> TATACACCACT
TATACACCACT -> ATACACCACTC
ATACACCACTC -> TACACCACTCC
TACACCACTCC -> ACACCACTCCG
ACACCACTCCG -> CACCACTCCGT
CACCACTCCGT -> ACCACTCCGTT
ACCACTCCGTT -> CCACTCCGTTA
CCACTCCGTTA -> CACTCCGTTAG
CACTCCGTTAG -> ACTCCGTTAGA
ACTCCGTTAGA -> CTCCGTTAGAT
CTCCGTTAGAT -> TCCGTTAGATC
TCCGTTAGATC -> CCGTTAGATCC
CCGTTAGATCC -> CGTTAGATCCA
CGTTAGATCCA -> GTTAGATCCAC
GTTAGATCCAC -> TTAGATCCACC
TTAGATCCACC -> TAGATCCACCA
TAGATCCACCA -> AGATCCACCAC
AGATCCACCAC -> GATCCACCACT
GATCCACCACT -> ATCCACCACTC
ATCCACCACTC -> TCCACCACTCT
TCCACCACTCT -> CCACCACTCTC
CCACCACTCTC -> CACCACTCTCG
CACCACTCTCG -> ACCACTCTCGC
ACCACTCTCGC -> CCACTCTCGCG
CCACTCTCGCG -> CACTCTCGCGG
CACTCTCGCGG -> ACTCTCGCGGA
ACTCTCGCGGA -> CTCTCGCGGAG
CTCTCGCGGAG -> TCTCGCGGAGT
TCTCGCGGAGT -> CTCGCGGAGTC
CTCGCGGAGTC -> TCGCGGAGTCG
TCGCGGAGTCG -> CGCGGAGTCGT
CGCGGAGTCGT -> GCGGAGTCGTA
GCGGAGTCGTA -> CGGAGTCGTAC
CGGAGTCGTAC -> GGAGTCGTACC
GGAGTCGTACC -> GAGTCGTACCA
AGTCGTACCAC -> GTCGTACCACA
GTCGTACCACA -> TCGTACCACAA
TCGTACCACAA -> CGTACCACAAA
CGTACCACAAA -> GTACCACAAAT
GTACCACAAAT -> TACCACAAATC
TACCACAAATC -> ACCACAAATCC
ACCACAAATCC -> CCACAAATCCT
CCACAAATCCT -> CACAAATCCTC
CACAAATCCTC -> ACAAATCCTCC
ACAAATCCTCC -> CAAATCCTCCT
CAAATCCTCCT -> AAATCCTCCTT
AAATCCTCCTT -> AATCCTCCTTA
AATCCTCCTTA -> ATCCTCCTTAC
ATCCTCCTTAC -> TCCTCCTTACC
TCCTCCTTACC -> CCTCCTTACCA
CCTCCTTACCA -> CTCCTTACCAG
CTCCTTACCAG -> TCCTTACCAGG
TCCTTACCAGG -> CCTTACCAGGG
CCTTACCAGGG -> CTTACCAGGGC
CTTACCAGGGC -> TTACCAGGGCG
TTACCAGGGCG -> TACCAGGGCGG
TACCAGGGCGG -> ACCAGGGCGGT
ACCAGGGCGGT -> CCAGGGCGGTG
CCAGGGCGGTG -> CAGGGCGGTGG
CAGGGCGGTGG -> AGGGCGGTGGC
AGGGCGGTGGC -> GGGCGGTGGCG
GGGCGGTGGCG -> GGCGGTGGCGT
GGCGGTGGCGT -> GCGGTGGCGTT
GCGGTGGCGTT -> CGGTGGCGTTC
CGGTGGCGTTC -> GGTGGCGTTCG
GGTGGCGTTCG -> GTGGCGTTCGC
GTGGCGTTCGC -> TGGCGTTCGCC
TGGCGTTCGCC -> GGCGTTCGCCA
GGCGTTCGCCA -> GCGTTCGCCAA
GCGTTCGCCAA -> CGTTCGCCAAA
CGTTCGCCAAA -> GTTCGCCAAAC
GTTCGCCAAAC -> TTCGCCAAACA
TTCGCCAAACA -> TCGCCAAACAG
TCGCCAAACAG -> CGCCAAACAGT
CGCCAAACAGT -> GCCAAACAGTA
GCCAAACAGTA -> CCAAACAGTAA
CCAAACAGTAA -> CAAACAGTAAA
CAAACAGTAAA -> AAACAGTAAAG
AAACAGTAAAG -> AACAGTAAAGC
AACAGTAAAGC -> ACAGTAAAGCA
ACAGTAAAGCA -> CAGTAAAGCAT
CAGTAAAGCAT -> AGTAAAGCATT
AGTAAAGCATT -> GTAAAGCATTG
GTAAAGCATTG -> TAAAGCATTGT
TAAAGCATTGT -> AAAGCATTGTA
AAAGCATTGTA -> AAGCATTGTAG
AAGCATTGTAG -> AGCATTGTAGT
AGCATTGTAGT -> GCATTGTAGTT
GCATTGTAGTT -> CATTGTAGTTG
CATTGTAGTTG -> ATTGTAGTTGG
ATTGTAGTTGG -> TTGTAGTTGGC
TTGTAGTTGGC -> TGTAGTTGGCC
TGTAGTTGGCC -> GTAGTTGGCCG
GTAGTTGGCCG -> TAGTTGGCCGG
TAGTTGGCCGG -> AGTTGGCCGGA
AGTTGGCCGGA -> GTTGGCCGGAA
GTTGGCCGGAA -> TTGGCCGGAAC
TTGGCCGGAAC -> TGGCCGGAACC
TGGCCGGAACC -> GGCCGGAACCC
GGCCGGAACCC -> GCCGGAACCCG
GCCGGAACCCG -> CCGGAACCCGA
CCGGAACCCGA -> CGGAACCCGAT
CGGAACCCGAT -> GGAACCCGATA
GGAACCCGATA -> GAACCCGATAA
GAACCCGATAA -> AACCCGATAAC
AACCCGATAAC -> ACCCGATAACT
ACCCGATAACT -> CCCGATAACTT
CCCGATAACTT -> CCGATAACTTG
CCGATAACTTG -> CGATAACTTGA
CGATAACTTGA -> GATAACTTGAT
GATAACTTGAT -> ATAACTTGATT
ATAACTTGATT -> TAACTTGATTC
TAACTTGATTC -> AACTTGATTCC
AACTTGATTCC -> ACTTGATTCCT
ACTTGATTCCT -> CTTGATTCCTA
CTTGATTCCTA -> TTGATTCCTAT
TTGATTCCTAT -> TGATTCCTATT
TGATTCCTATT -> GATTCCTATTT
GATTCCTATTT -> ATTCCTATTTC
ATTCCTATTTC -> TTCCTATTTCC
TTCCTATTTCC -> TCCTATTTCCA
TCCTATTTCCA -> CCTATTTCCAT
CCTATTTCCAT -> CTATTTCCATG
CTATTTCCATG -> TATTTCCATGA
TATTTCCATGA -> ATTTCCATGAC
ATTTCCATGAC -> TTTCCATGACC
TTTCCATGACC -> TTCCATGACCC
TTCCATGACCC -> TCCATGACCCC
TCCATGACCCC -> CCATGACCCCC
CCATGACCCCC -> CATGACCCCCC
CATGACCCCCC -> ATGACCCCCCC
ATGACCCCCCC -> TGACCCCCCCA
TGACCCCCCCA -> GACCCCCCCAA
GACCCCCCCAA -> ACCCCCCCAAC
ACCCCCCCAAC -> CCCCCCCAACC
CCCCCCCAACC -> CCCCCCAACCG
CCCCCCAACCG -> CCCCCAACCGA
CCCCCAACCGA -> CCCCAACCGAG
CCCCAACCGAG -> CCCAACCGAGC
CCCAACCGAGC -> CCAACCGAGCG
CCAACCGAGCG -> CAACCGAGCGT
CAACCGAGCGT -> AACCGAGCGTA
AACCGAGCGTA -> ACCGAGCGTAG
ACCGAGCGTAG -> CCGAGCGTAGG
CCGAGCGTAGG -> CGAGCGTAGGG
CGAGCGTAGGG -> GAGCGTAGGGC
GAGCGTAGGGC -> AGCGTAGGGCG
AGCGTAGGGCG -> GCGTAGGGCGT
GCGTAGGGCGT -> CGTAGGGCGTA
CGTAGGGCGTA -> GTAGGGCGTAT
GTAGGGCGTAT -> TAGGGCGTATC
TAGGGCGTATC -> AGGGCGTATCG
AGGGCGTATCG -> GGGCGTATCGT
GGGCGTATCGT -> GGCGTATCGTG
GGCGTATCGTG -> GCGTATCGTGG
GCGTATCGTGG -> CGTATCGTGGA
CGTATCGTGGA -> GTATCGTGGAG
GTATCGTGGAG -> TATCGTGGAGA
TATCGTGGAGA -> ATCGTGGAGAG
ATCGTGGAGAG -> TCGTGGAGAGC
TCGTGGAGAGC -> CGTGGAGAGCT
CGTGGAGAGCT -> GTGGAGAGCTG
GTGGAGAGCTG -> TGGAGAGCTGT
TGGAGAGCTGT -> GGAGAGCTGTA
GGAGAGCTGTA -> GAGAGCTGTAC
GAGAGCTGTAC -> AGAGCTGTACA
AGAGCTGTACA -> GAGCTGTACAA
GAGCTGTACAA -> AGCTGTACAAT
AGCTGTACAAT -> GCTGTACAATT
GCTGTACAATT -> CTGTACAATTA
CTGTACAATTA -> TGTACAATTAT
TGTACAATTAT -> GTACAATTATA
GTACAATTATA -> TACAATTATAT
TACAATTATAT -> ACAATTATATT
ACAATTATATT -> CAATTATATTC
CAATTATATTC -> AATTATATTCC
AATTATATTCC -> ATTATATTCCA
ATTATATTCCA -> TTATATTCCAT
TTATATTCCAT -> TATATTCCATT
TATATTCCATT -> ATATTCCATTT
ATATTCCATTT -> TATTCCATTTC
TATTCCATTTC -> ATTCCATTTCC
ATTCCATTTCC -> TTCCATTTCCC
TTCCATTTCCC -> TCCATTTCCCT
TCCATTTCCCT -> CCATTTCCCTA
CCATTTCCCTA -> CATTTCCCTAA
CATTTCCCTAA -> ATTTCCCTAAG
ATTTCCCTAAG -> TTTCCCTAAGG
TTTCCCTAAGG -> TTCCCTAAGGG
TTCCCTAAGGG -> TCCCTAAGGGC
TCCCTAAGGGC -> CCCTAAGGGCA
CCCTAAGGGCA -> CCTAAGGGCAC
CCTAAGGGCAC -> CTAAGGGCACC
CTAAGGGCACC -> TAAGGGCACCC
TAAGGGCACCC -> AAGGGCACCCG
AAGGGCACCCG -> AGGGCACCCGA
AGGGCACCCGA -> GGGCACCCGAC
GGGCACCCGAC -> GGCACCCGACT
GGCACCCGACT -> GCACCCGACTC
GCACCCGACTC -> CACCCGACTCT
CACCCGACTCT -> ACCCGACTCTC
ACCCGACTCTC -> CCCGACTCTCA
CCCGACTCTCA -> CCGACTCTCAA
CCGACTCTCAA -> CGACTCTCAAA
CGACTCTCAAA -> GACTCTCAAAG
GACTCTCAAAG -> ACTCTCAAAGA
ACTCTCAAAGA -> CTCTCAAAGAT
CTCTCAAAGAT -> TCTCAAAGATG
TCTCAAAGATG -> CTCAAAGATGA
CTCAAAGATGA -> TCAAAGATGAA
TCAAAGATGAA -> CAAAGATGAAG
CAAAGATGAAG -> AAAGATGAAGA
AAAGATGAAGA -> AAGATGAAGAT
AAGATGAAGAT -> AGATGAAGATC
AGATGAAGATC -> GATGAAGATCC
GATGAAGATCC -> ATGAAGATCCT
ATGAAGATCCT -> TGAAGATCCTA
TGAAGATCCTA -> GAAGATCCTAT
GAAGATCCTAT -> AAGATCCTATT
AAGATCCTATT -> AGATCCTATTG
AGATCCTATTG -> GATCCTATTGC
GATCCTATTGC -> ATCCTATTGCA
ATCCTATTGCA -> TCCTATTGCAA
TCCTATTGCAA -> CCTATTGCAAC
CCTATTGCAAC -> CTATTGCAACT
CTATTGCAACT -> TATTGCAACTA
TATTGCAACTA -> ATTGCAACTAC
ATTGCAACTAC -> TTGCAACTACA
TTGCAACTACA -> TGCAACTACAA
TGCAACTACAA -> GCAACTACAAT
GCAACTACAAT -> CAACTACAATT
CAACTACAATT -> AACTACAATTC
AACTACAATTC -> ACTACAATTCT
ACTACAATTCT -> CTACAATTCTA
CTACAATTCTA -> TACAATTCTAC
TACAATTCTAC -> ACAATTCTACA
ACAATTCTACA -> CAATTCTACAG
CAATTCTACAG -> AATTCTACAGG
AATTCTACAGG -> ATTCTACAGGA
ATTCTACAGGA -> TTCTACAGGAA
TTCTACAGGAA -> TCTACAGGAAG
TCTACAGGAAG -> CTACAGGAAGA
CTACAGGAAGA -> TACAGGAAGAC
TACAGGAAGAC -> ACAGGAAGACG
ACAGGAAGACG -> CAGGAAGACGT
CAGGAAGACGT -> AGGAAGACGTG
AGGAAGACGTG -> GGAAGACGTGA
GGAAGACGTGA -> GAAGACGTGAG
GAAGACGTGAG -> AAGACGTGAGC
AAGACGTGAGC -> AGACGTGAGCT
AGACGTGAGCT -> GACGTGAGCTT
GACGTGAGCTT -> ACGTGAGCTTT
ACGTGAGCTTT -> CGTGAGCTTTT
CGTGAGCTTTT -> GTGAGCTTTTG
GTGAGCTTTTG -> TGAGCTTTTGA
TGAGCTTTTGA -> GAGCTTTTGAA
GAGCTTTTGAA -> AGCTTTTGAAG
AGCTTTTGAAG -> GCTTTTGAAGA
GCTTTTGAAGA -> CTTTTGAAGAG
CTTTTGAAGAG -> TTTTGAAGAGG
TTTTGAAGAGG -> TTTGAAGAGGA
TTTGAAGAGGA -> TTGAAGAGGAC
TTGAAGAGGAC -> TGAAGAGGACG
TGAAGAGGACG -> GAAGAGGACGC
GAAGAGGACGC -> AAGAGGACGCC
AAGAGGACGCC -> AGAGGACGCCC
AGAGGACGCCC -> GAGGACGCCCG
GAGGACGCCCG -> AGGACGCCCGA
AGGACGCCCGA -> GGACGCCCGAC
GGACGCCCGAC -> GACGCCCGACA
GACGCCCGACA -> ACGCCCGACAG
ACGCCCGACAG -> CGCCCGACAGA
CGCCCGACAGA -> GCCCGACAGAT
GCCCGACAGAT -> CCCGACAGATT
CCCGACAGATT -> CCGACAGATTG
CCGACAGATTG -> CGACAGATTGG
CGACAGATTGG -> GACAGATTGGG
GACAGATTGGG -> ACAGATTGGGT
ACAGATTGGGT -> CAGATTGGGTC
CAGATTGGGTC -> AGATTGGGTCA
AGATTGGGTCA -> GATTGGGTCAT
GATTGGGTCAT -> ATTGGGTCATT
ATTGGGTCATT -> TTGGGTCATTA
TTGGGTCATTA -> TGGGTCATTAA
TGGGTCATTAA -> GGGTCATTAAC
GGGTCATTAAC -> GGTCATTAACT
GGTCATTAACT -> GTCATTAACTT
GTCATTAACTT -> TCATTAACTTT
TCATTAACTTT -> CATTAACTTTG
CATTAACTTTG -> ATTAACTTTGT
ATTAACTTTGT -> TTAACTTTGTC
TTAACTTTGTC -> TAACTTTGTCC
TAACTTTGTCC -> AACTTTGTCCG
AACTTTGTCCG -> ACTTTGTCCGC
ACTTTGTCCGC -> CTTTGTCCGCA
CTTTGTCCGCA -> TTTGTCCGCAT
TTTGTCCGCAT -> TTGTCCGCATA
TTGTCCGCATA -> TGTCCGCATAC
TGTCCGCATAC -> GTCCGCATACT
GTCCGCATACT -> TCCGCATACTG
TCCGCATACTG -> CCGCATACTGG
CCGCATACTGG -> CGCATACTGGC
CGCATACTGGC -> GCATACTGGCC
GCATACTGGCC -> CATACTGGCCT
CATACTGGCCT -> ATACTGGCCTA
ATACTGGCCTA -> TACTGGCCTAG
TACTGGCCTAG -> ACTGGCCTAGT
ACTGGCCTAGT -> CTGGCCTAGTG
CTGGCCTAGTG -> TGGCCTAGTGT
TGGCCTAGTGT -> GGCCTAGTGTC
GGCCTAGTGTC -> GCCTAGTGTCG
GCCTAGTGTCG -> CCTAGTGTCGC
CCTAGTGTCGC -> CTAGTGTCGCG
CTAGTGTCGCG -> TAGTGTCGCGA
TAGTGTCGCGA -> AGTGTCGCGAC
AGTGTCGCGAC -> GTGTCGCGACG
GTGTCGCGACG -> TGTCGCGACGT
TGTCGCGACGT -> GTCGCGACGTG
GTCGCGACGTG -> TCGCGACGTGT
TCGCGACGTGT -> CGCGACGTGTG
CGCGACGTGTG -> GCGACGTGTGT
GCGACGTGTGT -> CGACGTGTGTA
CGACGTGTGTA -> GACGTGTGTAC
GACGTGTGTAC -> ACGTGTGTACG
ACGTGTGTACG -> CGTGTGTACGT
CGTGTGTACGT -> GTGTGTACGTC
GTGTGTACGTC -> TGTGTACGTCG
TGTGTACGTCG -> GTGTACGTCGC
GTGTACGTCGC -> TGTACGTCGCG
TGTACGTCGCG -> GTACGTCGCGT
GTACGTCGCGT -> TACGTCGCGTC
TACGTCGCGTC -> ACGTCGCGTCC
ACGTCGCGTCC -> CGTCGCGTCCA
CGTCGCGTCCA -> GTCGCGTCCAA
GTCGCGTCCAA -> TCGCGTCCAAT
TCGCGTCCAAT -> CGCGTCCAATT
CGCGTCCAATT -> GCGTCCAATTC
GCGTCCAATTC -> CGTCCAATTCC
CGTCCAATTCC -> GTCCAATTCCT
GTCCAATTCCT -> TCCAATTCCTC
TCCAATTCCTC -> CCAATTCCTCT
CCAATTCCTCT -> CAATTCCTCTC
CAATTCCTCTC -> AATTCCTCTCT
AATTCCTCTCT -> ATTCCTCTCTT
ATTCCTCTCTT -> TTCCTCTCTTT
TTCCTCTCTTT -> TCCTCTCTTTA
TCCTCTCTTTA -> CCTCTCTTTAC
CCTCTCTTTAC -> CTCTCTTTACA
CTCTCTTTACA -> TCTCTTTACAC
TCTCTTTACAC -> CTCTTTACACC
CTCTTTACACC -> TCTTTACACCT
TCTTTACACCT -> CTTTACACCTG
CTTTACACCTG -> TTTACACCTGT
TTTACACCTGT -> TTACACCTGTG
TTACACCTGTG -> TACACCTGTGG
TACACCTGTGG -> ACACCTGTGGT
ACACCTGTGGT -> CACCTGTGGTA
CACCTGTGGTA -> ACCTGTGGTAT
ACCTGTGGTAT -> CCTGTGGTATG
CCTGTGGTATG -> CTGTGGTATGT
CTGTGGTATGT -> TGTGGTATGTC
TGTGGTATGTC -> GTGGTATGTCC
GTGGTATGTCC -> TGGTATGTCCT
TGGTATGTCCT -> GGTATGTCCTG
GGTATGTCCTG -> GTATGTCCTGT
GTATGTCCTGT -> TATGTCCTGTA
TATGTCCTGTA -> ATGTCCTGTAA
ATGTCCTGTAA -> TGTCCTGTAAC
TGTCCTGTAAC -> GTCCTGTAACT
GTCCTGTAACT -> TCCTGTAACTT
TCCTGTAACTT -> CCTGTAACTTG
CCTGTAACTTG -> CTGTAACTTGT
CTGTAACTTGT -> TGTAACTTGTT
TGTAACTTGTT -> GTAACTTGTTC
GTAACTTGTTC -> TAACTTGTTCT
TAACTTGTTCT -> AACTTGTTCTT
AACTTGTTCTT -> ACTTGTTCTTT
ACTTGTTCTTT -> CTTGTTCTTTA
CTTGTTCTTTA -> TTGTTCTTTAG
TTGTTCTTTAG -> TGTTCTTTAGC
TGTTCTTTAGC -> GTTCTTTAGCG
GTTCTTTAGCG -> TTCTTTAGCGA
TTCTTTAGCGA -> TCTTTAGCGAT
TCTTTAGCGAT -> CTTTAGCGATC
CTTTAGCGATC -> TTTAGCGATCG
TTTAGCGATCG -> TTAGCGATCGA
TTAGCGATCGA -> TAGCGATCGAG
TAGCGATCGAG -> AGCGATCGAGG
AGCGATCGAGG -> GCGATCGAGGA
GCGATCGAGGA -> CGATCGAGGAC
CGATCGAGGAC -> GATCGAGGACA
GATCGAGGACA -> ATCGAGGACAG
ATCGAGGACAG -> TCGAGGACAGC
TCGAGGACAGC -> CGAGGACAGCT
CGAGGACAGCT -> GAGGACAGCTG
GAGGACAGCTG -> AGGACAGCTGA
AGGACAGCTGA -> GGACAGCTGAG
GGACAGCTGAG -> GACAGCTGAGC
GACAGCTGAGC -> ACAGCTGAGCC
ACAGCTGAGCC -> CAGCTGAGCCA
CAGCTGAGCCA -> AGCTGAGCCAT
AGCTGAGCCAT -> GCTGAGCCATT
GCTGAGCCATT -> CTGAGCCATTC
CTGAGCCATTC -> TGAGCCATTCT
TGAGCCATTCT -> GAGCCATTCTA
GAGCCATTCTA -> AGCCATTCTAA
AGCCATTCTAA -> GCCATTCTAAA
GCCATTCTAAA -> CCATTCTAAAG
CCATTCTAAAG -> CATTCTAAAGT
CATTCTAAAGT -> ATTCTAAAGTT
ATTCTAAAGTT -> TTCTAAAGTTC
TTCTAAAGTTC -> TCTAAAGTTCC
TCTAAAGTTCC -> CTAAAGTTCCC
CTAAAGTTCCC -> TAAAGTTCCCT
TAAAGTTCCCT -> AAAGTTCCCTC
AAAGTTCCCTC -> AAGTTCCCTCA
AAGTTCCCTCA -> AGTTCCCTCAG
AGTTCCCTCAG -> GTTCCCTCAGT
GTTCCCTCAGT -> TTCCCTCAGTG
TTCCCTCAGTG -> TCCCTCAGTGT
TCCCTCAGTGT -> CCCTCAGTGTG
CCCTCAGTGTG -> CCTCAGTGTGC
CCTCAGTGTGC -> CTCAGTGTGCT
CTCAGTGTGCT -> TCAGTGTGCTA
TCAGTGTGCTA -> CAGTGTGCTAA
CAGTGTGCTAA -> AGTGTGCTAAC
AGTGTGCTAAC -> GTGTGCTAACA
GTGTGCTAACA -> TGTGCTAACAG
TGTGCTAACAG -> GTGCTAACAGC
GTGCTAACAGC -> TGCTAACAGCT
TGCTAACAGCT -> GCTAACAGCTA
GCTAACAGCTA -> CTAACAGCTAA
CTAACAGCTAA -> TAACAGCTAAT
TAACAGCTAAT -> AACAGCTAATA
AACAGCTAATA -> ACAGCTAATAG
ACAGCTAATAG -> CAGCTAATAGA
CAGCTAATAGA -> AGCTAATAGAG
AGCTAATAGAG -> GCTAATAGAGC
GCTAATAGAGC -> CTAATAGAGCC
CTAATAGAGCC -> TAATAGAGCCA
TAATAGAGCCA -> AATAGAGCCAA
AATAGAGCCAA -> ATAGAGCCAAG
ATAGAGCCAAG -> TAGAGCCAAGT
TAGAGCCAAGT -> AGAGCCAAGTG
AGAGCCAAGTG -> GAGCCAAGTGG
GAGCCAAGTGG -> AGCCAAGTGGC
AGCCAAGTGGC -> GCCAAGTGGCA
GCCAAGTGGCA -> CCAAGTGGCAC
CCAAGTGGCAC -> CAAGTGGCACA
CAAGTGGCACA -> AAGTGGCACAA
AAGTGGCACAA -> AGTGGCACAAT
AGTGGCACAAT -> GTGGCACAATC
GTGGCACAATC -> TGGCACAATCA
TGGCACAATCA -> GGCACAATCAT
GGCACAATCAT -> GCACAATCATT
GCACAATCATT -> CACAATCATTT
CACAATCATTT -> ACAATCATTTT
ACAATCATTTT -> CAATCATTTTA
CAATCATTTTA -> AATCATTTTAT
AATCATTTTAT -> ATCATTTTATG
ATCATTTTATG -> TCATTTTATGT
TCATTTTATGT -> CATTTTATGTG
CATTTTATGTG -> ATTTTATGTGC
ATTTTATGTGC -> TTTTATGTGCT
TTTTATGTGCT -> TTTATGTGCTA
TTTATGTGCTA -> TTATGTGCTAA
TTATGTGCTAA -> TATGTGCTAAG
TATGTGCTAAG -> ATGTGCTAAGA
ATGTGCTAAGA -> TGTGCTAAGAG
TGTGCTAAGAG -> GTGCTAAGAGC
GTGCTAAGAGC -> TGCTAAGAGCC
TGCTAAGAGCC -> GCTAAGAGCCC
GCTAAGAGCCC -> CTAAGAGCCCT
CTAAGAGCCCT -> TAAGAGCCCTG
TAAGAGCCCTG -> AAGAGCCCTGG
AAGAGCCCTGG -> AGAGCCCTGGG
AGAGCCCTGGG -> GAGCCCTGGGG
GAGCCCTGGGG -> AGCCCTGGGGA
AGCCCTGGGGA -> GCCCTGGGGAT
GCCCTGGGGAT -> CCCTGGGGATT
CCCTGGGGATT -> CCTGGGGATTG
CCTGGGGATTG -> CTGGGGATTGG
CTGGGGATTGG -> TGGGGATTGGA
TGGGGATTGGA -> GGGGATTGGAG
GGGGATTGGAG -> GGGATTGGAGG
GGGATTGGAGG -> GGATTGGAGGC
GGATTGGAGGC -> GATTGGAGGCT
GATTGGAGGCT -> ATTGGAGGCTA
ATTGGAGGCTA -> TTGGAGGCTAG
TTGGAGGCTAG -> TGGAGGCTAGA
TGGAGGCTAGA -> GGAGGCTAGAT
GGAGGCTAGAT -> GAGGCTAGATT
GAGGCTAGATT -> AGGCTAGATTA
AGGCTAGATTA -> GGCTAGATTAT
GGCTAGATTAT -> GCTAGATTATA
GCTAGATTATA -> CTAGATTATAT
CTAGATTATAT -> TAGATTATATA
TAGATTATATA -> AGATTATATAA
AGATTATATAA -> GATTATATAAA
GATTATATAAA -> ATTATATAAAC
ATTATATAAAC -> TTATATAAACC
TTATATAAACC -> TATATAAACCT
TATATAAACCT -> ATATAAACCTA
ATATAAACCTA -> TATAAACCTAA
TATAAACCTAA -> ATAAACCTAAA
ATAAACCTAAA -> TAAACCTAAAA
TAAACCTAAAA -> AAACCTAAAAT
AAACCTAAAAT -> AACCTAAAATG
AACCTAAAATG -> ACCTAAAATGT
ACCTAAAATGT -> CCTAAAATGTC
CCTAAAATGTC -> CTAAAATGTCT
CTAAAATGTCT -> TAAAATGTCTT
TAAAATGTCTT -> AAAATGTCTTC
AAAATGTCTTC -> AAATGTCTTCT
AAATGTCTTCT -> AATGTCTTCTT
AATGTCTTCTT -> ATGTCTTCTTA
ATGTCTTCTTA -> TGTCTTCTTAG
TGTCTTCTTAG -> GTCTTCTTAGG
GTCTTCTTAGG -> TCTTCTTAGGA
TCTTCTTAGGA -> CTTCTTAGGAA
CTTCTTAGGAA -> TTCTTAGGAAC
TTCTTAGGAAC -> TCTTAGGAACT
TCTTAGGAACT -> CTTAGGAACTC
CTTAGGAACTC -> TTAGGAACTCA
TTAGGAACTCA -> TAGGAACTCAT
TAGGAACTCAT -> AGGAACTCATA
AGGAACTCATA -> GGAACTCATAG
GGAACTCATAG -> GAACTCATAGT
GAACTCATAGT -> AACTCATAGTT
AACTCATAGTT -> ACTCATAGTTT
ACTCATAGTTT -> CTCATAGTTTA
CTCATAGTTTA -> TCATAGTTTAA
TCATAGTTTAA -> CATAGTTTAAT
CATAGTTTAAT -> ATAGTTTAATC
ATAGTTTAATC -> TAGTTTAATCA
TAGTTTAATCA -> AGTTTAATCAG
AGTTTAATCAG -> GTTTAATCAGG
GTTTAATCAGG -> TTTAATCAGGT
TTTAATCAGGT -> TTAATCAGGTA
TTAATCAGGTA -> TAATCAGGTAG
TAATCAGGTAG -> AATCAGGTAGA
AATCAGGTAGA -> ATCAGGTAGAC
ATCAGGTAGAC -> TCAGGTAGACG
TCAGGTAGACG -> CAGGTAGACGA
CAGGTAGACGA -> AGGTAGACGAT
AGGTAGACGAT -> GGTAGACGATG
GGTAGACGATG -> GTAGACGATGG
GTAGACGATGG -> TAGACGATGGT
TAGACGATGGT -> AGACGATGGTG
AGACGATGGTG -> GACGATGGTGA
GACGATGGTGA -> ACGATGGTGAT
CGATGGTGATG -> GATGGTGATGC
GATGGTGATGC -> ATGGTGATGCG
ATGGTGATGCG -> TGGTGATGCGT
TGGTGATGCGT -> GGTGATGCGTC
GGTGATGCGTC -> GTGATGCGTCA
GTGATGCGTCA -> TGATGCGTCAT
TGATGCGTCAT -> GATGCGTCATA
GATGCGTCATA -> ATGCGTCATAT
ATGCGTCATAT -> TGCGTCATATG
TGCGTCATATG -> GCGTCATATGT
GCGTCATATGT -> CGTCATATGTC
CGTCATATGTC -> GTCATATGTCA
GTCATATGTCA -> TCATATGTCAC
TCATATGTCAC -> CATATGTCACT
CATATGTCACT -> ATATGTCACTA
ATATGTCACTA -> TATGTCACTAC
TATGTCACTAC -> ATGTCACTACT
ATGTCACTACT -> TGTCACTACTT
TGTCACTACTT -> GTCACTACTTT
GTCACTACTTT -> TCACTACTTTC
TCACTACTTTC -> CACTACTTTCC
CACTACTTTCC -> ACTACTTTCCA
ACTACTTTCCA -> CTACTTTCCAA
CTACTTTCCAA -> TACTTTCCAAA
TACTTTCCAAA -> ACTTTCCAAAG
ACTTTCCAAAG -> CTTTCCAAAGG
CTTTCCAAAGG -> TTTCCAAAGGC
TTTCCAAAGGC -> TTCCAAAGGCC
TTCCAAAGGCC -> TCCAAAGGCCC
TCCAAAGGCCC -> CCAAAGGCCCC
CCAAAGGCCCC -> CAAAGGCCCCT
CAAAGGCCCCT -> AAAGGCCCCTC
AAAGGCCCCTC -> AAGGCCCCTCT
AAGGCCCCTCT -> AGGCCCCTCTC
AGGCCCCTCTC -> GGCCCCTCTCT
GGCCCCTCTCT -> GCCCCTCTCTC
GCCCCTCTCTC -> CCCCTCTCTCC
CCCCTCTCTCC -> CCCTCTCTCCC
CCCTCTCTCCC -> CCTCTCTCCCC
CCTCTCTCCCC -> CTCTCTCCCCT
CTCTCTCCCCT -> TCTCTCCCCTA
TCTCTCCCCTA -> CTCTCCCCTAT
CTCTCCCCTAT -> TCTCCCCTATA
TCTCCCCTATA -> CTCCCCTATAC
CTCCCCTATAC -> TCCCCTATACT
TCCCCTATACT -> CCCCTATACTA
CCCCTATACTA -> CCCTATACTAA
CCCTATACTAA -> CCTATACTAAC
CCTATACTAAC -> CTATACTAACA
CTATACTAACA -> TATACTAACAG
TATACTAACAG -> ATACTAACAGT
ATACTAACAGT -> TACTAACAGTC
TACTAACAGTC -> ACTAACAGTCG
ACTAACAGTCG -> CTAACAGTCGC
CTAACAGTCGC -> TAACAGTCGCG
TAACAGTCGCG -> AACAGTCGCGC
AACAGTCGCGC -> ACAGTCGCGCG
ACAGTCGCGCG -> CAGTCGCGCGT
CAGTCGCGCGT -> AGTCGCGCGTT
AGTCGCGCGTT -> GTCGCGCGTTG
GTCGCGCGTTG -> TCGCGCGTTGA
TCGCGCGTTGA -> CGCGCGTTGAA
CGCGCGTTGAA -> GCGCGTTGAAC
GCGCGTTGAAC -> CGCGTTGAACC
CGCGTTGAACC -> GCGTTGAACCC
GCGTTGAACCC -> CGTTGAACCCG
CGTTGAACCCG -> GTTGAACCCGA
GTTGAACCCGA -> TTGAACCCGAG
TTGAACCCGAG -> TGAACCCGAGG
TGAACCCGAGG -> GAACCCGAGGC
GAACCCGAGGC -> AACCCGAGGCT
AACCCGAGGCT -> ACCCGAGGCTG
ACCCGAGGCTG -> CCCGAGGCTGG
CCCGAGGCTGG -> CCGAGGCTGGT
CCGAGGCTGGT -> CGAGGCTGGTA
CGAGGCTGGTA -> GAGGCTGGTAT
GAGGCTGGTAT -> AGGCTGGTATT
AGGCTGGTATT -> GGCTGGTATTG
GGCTGGTATTG -> GCTGGTATTGA
GCTGGTATTGA -> CTGGTATTGAC
CTGGTATTGAC -> TGGTATTGACA
TGGTATTGACA -> GGTATTGACAC
GGTATTGACAC -> GTATTGACACT
GTATTGACACT -> TATTGACACTG
TATTGACACTG -> ATTGACACTGA
ATTGACACTGA -> TTGACACTGAT
TTGACACTGAT -> TGACACTGATG
TGACACTGATG -> GACACTGATGA
GACACTGATGA -> ACACTGATGAG
ACACTGATGAG -> CACTGATGAGT
CACTGATGAGT -> ACTGATGAGTC
ACTGATGAGTC -> CTGATGAGTCC
CTGATGAGTCC -> TGATGAGTCCT
TGATGAGTCCT -> GATGAGTCCTG
GATGAGTCCTG -> ATGAGTCCTGC
ATGAGTCCTGC -> TGAGTCCTGCA
TGAGTCCTGCA -> GAGTCCTGCAG
GAGTCCTGCAG -> AGTCCTGCAGT
AGTCCTGCAGT -> GTCCTGCAGTA
GTCCTGCAGTA -> TCCTGCAGTAC
TCCTGCAGTAC -> CCTGCAGTACG
CCTGCAGTACG -> CTGCAGTACGA
CTGCAGTACGA -> TGCAGTACGAA
TGCAGTACGAA -> GCAGTACGAAT
GCAGTACGAAT -> CAGTACGAATG
CAGTACGAATG -> AGTACGAATGA
AGTACGAATGA -> GTACGAATGAC
GTACGAATGAC -> TACGAATGACT
TACGAATGACT -> ACGAATGACTA
ACGAATGACTA -> CGAATGACTAC
CGAATGACTAC -> GAATGACTACC
GAATGACTACC -> AATGACTACCC
AATGACTACCC -> ATGACTACCCC
ATGACTACCCC -> TGACTACCCCG
TGACTACCCCG -> GACTACCCCGC
GACTACCCCGC -> ACTACCCCGCG
ACTACCCCGCG -> CTACCCCGCGA
CTACCCCGCGA -> TACCCCGCGAC
TACCCCGCGAC -> ACCCCGCGACA
ACCCCGCGACA -> CCCCGCGACAC
CCCCGCGACAC -> CCCGCGACACT
CCCGCGACACT -> CCGCGACACTC
CCGCGACACTC -> CGCGACACTCA
CGCGACACTCA -> GCGACACTCAT
GCGACACTCAT -> CGACACTCATG
CGACACTCATG -> GACACTCATGC
GACACTCATGC -> ACACTCATGCT
ACACTCATGCT -> CACTCATGCTA
CACTCATGCTA -> ACTCATGCTAT
ACTCATGCTAT -> CTCATGCTATG
CTCATGCTATG -> TCATGCTATGC
TCATGCTATGC -> CATGCTATGCG
CATGCTATGCG -> ATGCTATGCGA
ATGCTATGCGA -> TGCTATGCGAT
TGCTATGCGAT -> GCTATGCGATT
GCTATGCGATT -> CTATGCGATTC
CTATGCGATTC -> TATGCGATTCA
TATGCGATTCA -> ATGCGATTCAC
ATGCGATTCAC -> TGCGATTCACA
TGCGATTCACA -> GCGATTCACAC
GCGATTCACAC -> CGATTCACACG
CGATTCACACG -> GATTCACACGA
GATTCACACGA -> ATTCACACGAC
ATTCACACGAC -> TTCACACGACC
TTCACACGACC -> TCACACGACCC
TCACACGACCC -> CACACGACCCG
CACACGACCCG -> ACACGACCCGG
ACACGACCCGG -> CACGACCCGGA
CACGACCCGGA -> ACGACCCGGAA
ACGACCCGGAA -> CGACCCGGAAA
CGACCCGGAAA -> GACCCGGAAAT
GACCCGGAAAT -> ACCCGGAAATT
ACCCGGAAATT -> CCCGGAAATTC
CCCGGAAATTC -> CCGGAAATTCT
CCGGAAATTCT -> CGGAAATTCTC
CGGAAATTCTC -> GGAAATTCTCG
GGAAATTCTCG -> GAAATTCTCGT
GAAATTCTCGT -> AAATTCTCGTG
AAATTCTCGTG -> AATTCTCGTGG
AATTCTCGTGG -> ATTCTCGTGGA
ATTCTCGTGGA -> TTCTCGTGGAT
TTCTCGTGGAT -> TCTCGTGGATG
TCTCGTGGATG -> CTCGTGGATGT
CTCGTGGATGT -> TCGTGGATGTT
TCGTGGATGTT -> CGTGGATGTTA
CGTGGATGTTA -> GTGGATGTTAC
GTGGATGTTAC -> TGGATGTTACG
TGGATGTTACG -> GGATGTTACGA
GGATGTTACGA -> GATGTTACGAC
GATGTTACGAC -> ATGTTACGACA
ATGTTACGACA -> TGTTACGACAA
TGTTACGACAA -> GTTACGACAAC
GTTACGACAAC -> TTACGACAACG
TTACGACAACG -> TACGACAACGC
TACGACAACGC -> ACGACAACGCA
ACGACAACGCA -> CGACAACGCAG
CGACAACGCAG -> GACAACGCAGA
GACAACGCAGA -> ACAACGCAGAG
ACAACGCAGAG -> CAACGCAGAGC
CAACGCAGAGC -> AACGCAGAGCT
AACGCAGAGCT -> ACGCAGAGCTC
ACGCAGAGCTC -> CGCAGAGCTCA
CGCAGAGCTCA -> GCAGAGCTCAT
GCAGAGCTCAT -> CAGAGCTCATG
CAGAGCTCATG -> AGAGCTCATGA
AGAGCTCATGA -> GAGCTCATGAG
GAGCTCATGAG -> AGCTCATGAGC
AGCTCATGAGC -> GCTCATGAGCT
GCTCATGAGCT -> CTCATGAGCTG
CTCATGAGCTG -> TCATGAGCTGA
TCATGAGCTGA -> CATGAGCTGAA
CATGAGCTGAA -> ATGAGCTGAAT
ATGAGCTGAAT -> TGAGCTGAATA
TGAGCTGAATA -> GAGCTGAATAG
GAGCTGAATAG -> AGCTGAATAGC
AGCTGAATAGC -> GCTGAATAGCC
GCTGAATAGCC -> CTGAATAGCCC
CTGAATAGCCC -> TGAATAGCCCG
TGAATAGCCCG -> GAATAGCCCGC
GAATAGCCCGC -> AATAGCCCGCC
AATAGCCCGCC -> ATAGCCCGCCA
ATAGCCCGCCA -> TAGCCCGCCAA
TAGCCCGCCAA -> AGCCCGCCAAC
AGCCCGCCAAC -> GCCCGCCAACA
GCCCGCCAACA -> CCCGCCAACAC
CCCGCCAACAC -> CCGCCAACACG
CCGCCAACACG -> CGCCAACACGC
CGCCAACACGC -> GCCAACACGCT
GCCAACACGCT -> CCAACACGCTT
CCAACACGCTT -> CAACACGCTTT
CAACACGCTTT -> AACACGCTTTG
AACACGCTTTG -> ACACGCTTTGC
ACACGCTTTGC -> CACGCTTTGCT
CACGCTTTGCT -> ACGCTTTGCTC
ACGCTTTGCTC -> CGCTTTGCTCC
CGCTTTGCTCC -> GCTTTGCTCCC
GCTTTGCTCCC -> CTTTGCTCCCT
CTTTGCTCCCT -> TTTGCTCCCTG
TTTGCTCCCTG -> TTGCTCCCTGG
TTGCTCCCTGG -> TGCTCCCTGGA
TGCTCCCTGGA -> GCTCCCTGGAC
GCTCCCTGGAC -> CTCCCTGGACT
CTCCCTGGACT -> TCCCTGGACTA
TCCCTGGACTA -> CCCTGGACTAC
CCCTGGACTAC -> CCTGGACTACT
CCTGGACTACT -> CTGGACTACTC
CTGGACTACTC -> TGGACTACTCT
TGGACTACTCT -> GGACTACTCTA
GGACTACTCTA -> GACTACTCTAG
GACTACTCTAG -> ACTACTCTAGG
ACTACTCTAGG -> CTACTCTAGGA
CTACTCTAGGA -> TACTCTAGGAG
TACTCTAGGAG -> ACTCTAGGAGT
ACTCTAGGAGT -> CTCTAGGAGTC
CTCTAGGAGTC -> TCTAGGAGTCA
TCTAGGAGTCA -> CTAGGAGTCAT
CTAGGAGTCAT -> TAGGAGTCATT
TAGGAGTCATT -> AGGAGTCATTG
AGGAGTCATTG -> GGAGTCATTGC
GGAGTCATTGC -> GAGTCATTGCG
GAGTCATTGCG -> AGTCATTGCGT
AGTCATTGCGT -> GTCATTGCGTA
GTCATTGCGTA -> TCATTGCGTAT
TCATTGCGTAT -> CATTGCGTATT
CATTGCGTATT -> ATTGCGTATTC
ATTGCGTATTC -> TTGCGTATTCC
TTGCGTATTCC -> TGCGTATTCCT
TGCGTATTCCT -> GCGTATTCCTC
GCGTATTCCTC -> CGTATTCCTCG
CGTATTCCTCG -> GTATTCCTCGC
GTATTCCTCGC -> TATTCCTCGCT
TATTCCTCGCT -> ATTCCTCGCTC
ATTCCTCGCTC -> TTCCTCGCTCG
TTCCTCGCTCG -> TCCTCGCTCGG
TCCTCGCTCGG -> CCTCGCTCGGA
CCTCGCTCGGA -> CTCGCTCGGAC
CTCGCTCGGAC -> TCGCTCGGACG
TCGCTCGGACG -> CGCTCGGACGC
CGCTCGGACGC -> GCTCGGACGCA
GCTCGGACGCA -> CTCGGACGCAT
CTCGGACGCAT -> TCGGACGCATG
TCGGACGCATG -> CGGACGCATGA
CGGACGCATGA -> GGACGCATGAC
GGACGCATGAC -> GACGCATGACC
GACGCATGACC -> ACGCATGACCC
ACGCATGACCC -> CGCATGACCCT
CGCATGACCCT -> GCATGACCCTC
GCATGACCCTC -> CATGACCCTCA
CATGACCCTCA -> ATGACCCTCAT
ATGACCCTCAT -> TGACCCTCATT
TGACCCTCATT -> GACCCTCATTC
GACCCTCATTC -> ACCCTCATTCT
ACCCTCATTCT -> CCCTCATTCTG
CCCTCATTCTG -> CCTCATTCTGG
CCTCATTCTGG -> CTCATTCTGGA
CTCATTCTGGA -> TCATTCTGGAC
TCATTCTGGAC -> CATTCTGGACC
CATTCTGGACC -> ATTCTGGACCA
ATTCTGGACCA -> TTCTGGACCAG
TTCTGGACCAG -> TCTGGACCAGG
TCTGGACCAGG -> CTGGACCAGGC
CTGGACCAGGC -> TGGACCAGGCG
TGGACCAGGCG -> GGACCAGGCGA
GGACCAGGCGA -> GACCAGGCGAG
GACCAGGCGAG -> ACCAGGCGAGC
ACCAGGCGAGC -> CCAGGCGAGCC
CCAGGCGAGCC -> CAGGCGAGCCC
CAGGCGAGCCC -> AGGCGAGCCCG
AGGCGAGCCCG -> GGCGAGCCCGC
GGCGAGCCCGC -> GCGAGCCCGCC
GCGAGCCCGCC -> CGAGCCCGCCT
CGAGCCCGCCT -> GAGCCCGCCTT
GAGCCCGCCTT -> AGCCCGCCTTC
AGCCCGCCTTC -> GCCCGCCTTCA
GCCCGCCTTCA -> CCCGCCTTCAA
CCCGCCTTCAA -> CCGCCTTCAAA
CCGCCTTCAAA -> CGCCTTCAAAA
CGCCTTCAAAA -> GCCTTCAAAAA
GCCTTCAAAAA -> CCTTCAAAAAG
CCTTCAAAAAG -> CTTCAAAAAGG
CTTCAAAAAGG -> TTCAAAAAGGG
TTCAAAAAGGG -> TCAAAAAGGGA
TCAAAAAGGGA -> CAAAAAGGGAA
CAAAAAGGGAA -> AAAAAGGGAAT
AAAAAGGGAAT -> AAAAGGGAATT
AAAAGGGAATT -> AAAGGGAATTT
AAAGGGAATTT -> AAGGGAATTTC
AAGGGAATTTC -> AGGGAATTTCC
AGGGAATTTCC -> GGGAATTTCCA
GGGAATTTCCA -> GGAATTTCCAA
GGAATTTCCAA -> GAATTTCCAAC
GAATTTCCAAC -> AATTTCCAACA
AATTTCCAACA -> ATTTCCAACAC
ATTTCCAACAC -> TTTCCAACACT
TTTCCAACACT -> TTCCAACACTT
TTCCAACACTT -> TCCAACACTTA
TCCAACACTTA -> CCAACACTTAA
CCAACACTTAA -> CAACACTTAAG
CAACACTTAAG -> AACACTTAAGG
AACACTTAAGG -> ACACTTAAGGA
ACACTTAAGGA -> CACTTAAGGAT
CACTTAAGGAT -> ACTTAAGGATA
ACTTAAGGATA -> CTTAAGGATAG
CTTAAGGATAG -> TTAAGGATAGC
TTAAGGATAGC -> TAAGGATAGCC
TAAGGATAGCC -> AAGGATAGCCT
AAGGATAGCCT -> AGGATAGCCTA
AGGATAGCCTA -> GGATAGCCTAC
GGATAGCCTAC -> GATAGCCTACG
GATAGCCTACG -> ATAGCCTACGA
ATAGCCTACGA -> TAGCCTACGAC
TAGCCTACGAC -> AGCCTACGACG
AGCCTACGACG -> GCCTACGACGT
GCCTACGACGT -> CCTACGACGTG
CCTACGACGTG -> CTACGACGTGT
CTACGACGTGT -> TACGACGTGTC
TACGACGTGTC -> ACGACGTGTCA
ACGACGTGTCA -> CGACGTGTCAG
CGACGTGTCAG -> GACGTGTCAGC
GACGTGTCAGC -> ACGTGTCAGCT
ACGTGTCAGCT -> CGTGTCAGCTG
CGTGTCAGCTG -> GTGTCAGCTGT
GTGTCAGCTGT -> TGTCAGCTGTA
TGTCAGCTGTA -> GTCAGCTGTAC
GTCAGCTGTAC -> TCAGCTGTACC
TCAGCTGTACC -> CAGCTGTACCC
CAGCTGTACCC -> AGCTGTACCCC
AGCTGTACCCC -> GCTGTACCCCA
GCTGTACCCCA -> CTGTACCCCAA
CTGTACCCCAA -> TGTACCCCAAT
TGTACCCCAAT -> GTACCCCAATA
GTACCCCAATA -> TACCCCAATAT
TACCCCAATAT -> ACCCCAATATA
ACCCCAATATA -> CCCCAATATAC
CCCCAATATAC -> CCCAATATACA
CCCAATATACA -> CCAATATACAC
CCAATATACAC -> CAATATACACC
CAATATACACC -> AATATACACCT
AATATACACCT -> ATATACACCTT
ATATACACCTT -> TATACACCTTC
TATACACCTTC -> ATACACCTTCT
ATACACCTTCT -> TACACCTTCTA
TACACCTTCTA -> ACACCTTCTAG
ACACCTTCTAG -> CACCTTCTAGT
CACCTTCTAGT -> ACCTTCTAGTC
ACCTTCTAGTC -> CCTTCTAGTCT
CCTTCTAGTCT -> CTTCTAGTCTG
CTTCTAGTCTG -> TTCTAGTCTGC
TTCTAGTCTGC -> TCTAGTCTGCA
TCTAGTCTGCA -> CTAGTCTGCAC
CTAGTCTGCAC -> TAGTCTGCACG
TAGTCTGCACG -> AGTCTGCACGA
AGTCTGCACGA -> GTCTGCACGAT
GTCTGCACGAT -> TCTGCACGATT
TCTGCACGATT -> CTGCACGATTG
CTGCACGATTG -> TGCACGATTGC
TGCACGATTGC -> GCACGATTGCA
GCACGATTGCA -> CACGATTGCAA
CACGATTGCAA -> ACGATTGCAAA
ACGATTGCAAA -> CGATTGCAAAT
CGATTGCAAAT -> GATTGCAAATG
GATTGCAAATG -> ATTGCAAATGG
ATTGCAAATGG -> TTGCAAATGGC
TTGCAAATGGC -> TGCAAATGGCG
TGCAAATGGCG -> GCAAATGGCGT
GCAAATGGCGT -> CAAATGGCGTC
CAAATGGCGTC -> AAATGGCGTCT
AAATGGCGTCT -> AATGGCGTCTA
AATGGCGTCTA -> ATGGCGTCTAG
ATGGCGTCTAG -> TGGCGTCTAGT
TGGCGTCTAGT -> GGCGTCTAGTA
GGCGTCTAGTA -> GCGTCTAGTAC
GCGTCTAGTAC -> CGTCTAGTACA
CGTCTAGTACA -> GTCTAGTACAA
GTCTAGTACAA -> TCTAGTACAAG
TCTAGTACAAG -> CTAGTACAAGA
CTAGTACAAGA -> TAGTACAAGAG
TAGTACAAGAG -> AGTACAAGAGA
AGTACAAGAGA -> GTACAAGAGAA
GTACAAGAGAA -> TACAAGAGAAG
TACAAGAGAAG -> ACAAGAGAAGT
ACAAGAGAAGT -> CAAGAGAAGTT
CAAGAGAAGTT -> AAGAGAAGTTA
AAGAGAAGTTA -> AGAGAAGTTAC
AGAGAAGTTAC -> GAGAAGTTACA
GAGAAGTTACA -> AGAAGTTACAA
AGAAGTTACAA -> GAAGTTACAAG
GAAGTTACAAG -> AAGTTACAAGC
AAGTTACAAGC -> AGTTACAAGCG
AGTTACAAGCG -> GTTACAAGCGA
GTTACAAGCGA -> TTACAAGCGAA
TTACAAGCGAA -> TACAAGCGAAG
TACAAGCGAAG -> ACAAGCGAAGA
ACAAGCGAAGA -> CAAGCGAAGAT
CAAGCGAAGAT -> AAGCGAAGATC
AAGCGAAGATC -> AGCGAAGATCA
AGCGAAGATCA -> GCGAAGATCAC
GCGAAGATCAC -> CGAAGATCACG
CGAAGATCACG -> GAAGATCACGA
GAAGATCACGA -> AAGATCACGAG
AAGATCACGAG -> AGATCACGAGG
AGATCACGAGG -> GATCACGAGGT
GATCACGAGGT -> ATCACGAGGTT
ATCACGAGGTT -> TCACGAGGTTC
TCACGAGGTTC -> CACGAGGTTCA
CACGAGGTTCA -> ACGAGGTTCAC
ACGAGGTTCAC -> CGAGGTTCACA
CGAGGTTCACA -> GAGGTTCACAT
GAGGTTCACAT -> AGGTTCACATA
AGGTTCACATA -> GGTTCACATAT
GGTTCACATAT -> GTTCACATATC
GTTCACATATC -> TTCACATATCA
TTCACATATCA -> TCACATATCAA
TCACATATCAA -> CACATATCAAC
CACATATCAAC -> ACATATCAACG
ACATATCAACG -> CATATCAACGC
CATATCAACGC -> ATATCAACGCC
ATATCAACGCC -> TATCAACGCCG
TATCAACGCCG -> ATCAACGCCGG
ATCAACGCCGG -> TCAACGCCGGT
TCAACGCCGGT -> CAACGCCGGTC
CAACGCCGGTC -> AACGCCGGTCT
AACGCCGGTCT -> ACGCCGGTCTC
ACGCCGGTCTC -> CGCCGGTCTCG
CGCCGGTCTCG -> GCCGGTCTCGA
GCCGGTCTCGA -> CCGGTCTCGAC
CCGGTCTCGAC -> CGGTCTCGACA
CGGTCTCGACA -> GGTCTCGACAG
GGTCTCGACAG -> GTCTCGACAGA
GTCTCGACAGA -> TCTCGACAGAT
TCTCGACAGAT -> CTCGACAGATC
CTCGACAGATC -> TCGACAGATCC
TCGACAGATCC -> CGACAGATCCT
CGACAGATCCT -> GACAGATCCTA
GACAGATCCTA -> ACAGATCCTAC
ACAGATCCTAC -> CAGATCCTACG
CAGATCCTACG -> AGATCCTACGA
AGATCCTACGA -> GATCCTACGAT
GATCCTACGAT -> ATCCTACGATG
ATCCTACGATG -> TCCTACGATGG
TCCTACGATGG -> CCTACGATGGA
CCTACGATGGA -> CTACGATGGAC
CTACGATGGAC -> TACGATGGACT
TACGATGGACT -> ACGATGGACTT
ACGATGGACTT -> CGATGGACTTT
CGATGGACTTT -> GATGGACTTTT
GATGGACTTTT -> ATGGACTTTTG
ATGGACTTTTG -> TGGACTTTTGA
TGGACTTTTGA -> GGACTTTTGAG
GGACTTTTGAG -> GACTTTTGAGA
GACTTTTGAGA -> ACTTTTGAGAG
ACTTTTGAGAG -> CTTTTGAGAGG
CTTTTGAGAGG -> TTTTGAGAGGG
TTTTGAGAGGG -> TTTGAGAGGGA
TTTGAGAGGGA -> TTGAGAGGGAA
TTGAGAGGGAA -> TGAGAGGGAAT
TGAGAGGGAAT -> GAGAGGGAATC
GAGAGGGAATC -> AGAGGGAATCC
AGAGGGAATCC -> GAGGGAATCCG
GAGGGAATCCG -> AGGGAATCCGT
AGGGAATCCGT -> GGGAATCCGTT
GGGAATCCGTT -> GGAATCCGTTA
GGAATCCGTTA -> GAATCCGTTAA
GAATCCGTTAA -> AATCCGTTAAA
AATCCGTTAAA -> ATCCGTTAAAA
ATCCGTTAAAA -> TCCGTTAAAAT
TCCGTTAAAAT -> CCGTTAAAATA
CCGTTAAAATA -> CGTTAAAATAG
CGTTAAAATAG -> GTTAAAATAGC
GTTAAAATAGC -> TTAAAATAGCG
TTAAAATAGCG -> TAAAATAGCGT
TAAAATAGCGT -> AAAATAGCGTT
AAAATAGCGTT -> AAATAGCGTTA
AAATAGCGTTA -> AATAGCGTTAC
AATAGCGTTAC -> ATAGCGTTACC
ATAGCGTTACC -> TAGCGTTACCT
TAGCGTTACCT -> AGCGTTACCTC
AGCGTTACCTC -> GCGTTACCTCT
GCGTTACCTCT -> CGTTACCTCTA
CGTTACCTCTA -> GTTACCTCTAG
GTTACCTCTAG -> TTACCTCTAGG
TTACCTCTAGG -> TACCTCTAGGA
TACCTCTAGGA -> ACCTCTAGGAA
ACCTCTAGGAA -> CCTCTAGGAAA
CCTCTAGGAAA -> CTCTAGGAAAG
CTCTAGGAAAG -> TCTAGGAAAGT
TCTAGGAAAGT -> CTAGGAAAGTG
CTAGGAAAGTG -> TAGGAAAGTGG
TAGGAAAGTGG -> AGGAAAGTGGA
AGGAAAGTGGA -> GGAAAGTGGAT
GGAAAGTGGAT -> GAAAGTGGATG
GAAAGTGGATG -> AAAGTGGATGT
AAAGTGGATGT -> AAGTGGATGTA
AAGTGGATGTA -> AGTGGATGTAC
AGTGGATGTAC -> GTGGATGTACT
GTGGATGTACT -> TGGATGTACTG
TGGATGTACTG -> GGATGTACTGA
GGATGTACTGA -> GATGTACTGAC
GATGTACTGAC -> ATGTACTGACT
ATGTACTGACT -> TGTACTGACTG
TGTACTGACTG -> GTACTGACTGA
GTACTGACTGA -> TACTGACTGAA
TACTGACTGAA -> ACTGACTGAAA
ACTGACTGAAA -> CTGACTGAAAA
CTGACTGAAAA -> TGACTGAAAAA
TGACTGAAAAA -> GACTGAAAAAG
GACTGAAAAAG -> ACTGAAAAAGT
ACTGAAAAAGT -> CTGAAAAAGTG
CTGAAAAAGTG -> TGAAAAAGTGG
TGAAAAAGTGG -> GAAAAAGTGGG
GAAAAAGTGGG -> AAAAAGTGGGA
AAAAAGTGGGA -> AAAAGTGGGAA
AAAAGTGGGAA -> AAAGTGGGAAC
AAAGTGGGAAC -> AAGTGGGAACC
AAGTGGGAACC -> AGTGGGAACCG
AGTGGGAACCG -> GTGGGAACCGC
GTGGGAACCGC -> TGGGAACCGCC
TGGGAACCGCC -> GGGAACCGCCT
GGGAACCGCCT -> GGAACCGCCTC
GGAACCGCCTC -> GAACCGCCTCA
GAACCGCCTCA -> AACCGCCTCAA
AACCGCCTCAA -> ACCGCCTCAAA
ACCGCCTCAAA -> CCGCCTCAAAT
CCGCCTCAAAT -> CGCCTCAAATA
CGCCTCAAATA -> GCCTCAAATAA
GCCTCAAATAA -> CCTCAAATAAC
CCTCAAATAAC -> CTCAAATAACG
CTCAAATAACG -> TCAAATAACGC
TCAAATAACGC -> CAAATAACGCC
CAAATAACGCC -> AAATAACGCCA
AAATAACGCCA -> AATAACGCCAT
AATAACGCCAT -> ATAACGCCATA
ATAACGCCATA -> TAACGCCATAC
TAACGCCATAC -> AACGCCATACA
AACGCCATACA -> ACGCCATACAC
ACGCCATACAC -> CGCCATACACG
CGCCATACACG -> GCCATACACGC
GCCATACACGC -> CCATACACGCG
CCATACACGCG -> CATACACGCGT
CATACACGCGT -> ATACACGCGTC
ATACACGCGTC -> TACACGCGTCT
TACACGCGTCT -> ACACGCGTCTA
ACACGCGTCTA -> CACGCGTCTAC
CACGCGTCTAC -> ACGCGTCTACA
ACGCGTCTACA -> CGCGTCTACAG
CGCGTCTACAG -> GCGTCTACAGC
GCGTCTACAGC -> CGTCTACAGCG
CGTCTACAGCG -> GTCTACAGCGT
GTCTACAGCGT -> TCTACAGCGTT
TCTACAGCGTT -> CTACAGCGTTA
CTACAGCGTTA -> TACAGCGTTAG
TACAGCGTTAG -> ACAGCGTTAGA
ACAGCGTTAGA -> CAGCGTTAGAA
CAGCGTTAGAA -> AGCGTTAGAAA
AGCGTTAGAAA -> GCGTTAGAAAG
GCGTTAGAAAG -> CGTTAGAAAGA
CGTTAGAAAGA -> GTTAGAAAGAC
GTTAGAAAGAC -> TTAGAAAGACG
TTAGAAAGACG -> TAGAAAGACGT
TAGAAAGACGT -> AGAAAGACGTA
AGAAAGACGTA -> GAAAGACGTAT
GAAAGACGTAT -> AAAGACGTATC
AAAGACGTATC -> AAGACGTATCA
AAGACGTATCA -> AGACGTATCAT
AGACGTATCAT -> GACGTATCATG
GACGTATCATG -> ACGTATCATGG
ACGTATCATGG -> CGTATCATGGA
CGTATCATGGA -> GTATCATGGAT
GTATCATGGAT -> TATCATGGATA
TATCATGGATA -> ATCATGGATAG
ATCATGGATAG -> TCATGGATAGA
TCATGGATAGA -> CATGGATAGAG
CATGGATAGAG -> ATGGATAGAGT
ATGGATAGAGT -> TGGATAGAGTG
TGGATAGAGTG -> GGATAGAGTGC
GGATAGAGTGC -> GATAGAGTGCG
GATAGAGTGCG -> ATAGAGTGCGT
ATAGAGTGCGT -> TAGAGTGCGTC
TAGAGTGCGTC -> AGAGTGCGTCG
AGAGTGCGTCG -> GAGTGCGTCGT
GAGTGCGTCGT -> AGTGCGTCGTA
AGTGCGTCGTA -> GTGCGTCGTAC
GTGCGTCGTAC -> TGCGTCGTACC
TGCGTCGTACC -> GCGTCGTACCA
GCGTCGTACCA -> CGTCGTACCAC
CGTCGTACCAC -> GTCGTACCACC
GTCGTACCACC -> TCGTACCACCT
TCGTACCACCT -> CGTACCACCTA
CGTACCACCTA -> GTACCACCTAT
GTACCACCTAT -> TACCACCTATG
TACCACCTATG -> ACCACCTATGG
ACCACCTATGG -> CCACCTATGGC
CCACCTATGGC -> CACCTATGGCA
CACCTATGGCA -> ACCTATGGCAA
ACCTATGGCAA -> CCTATGGCAAC
CCTATGGCAAC -> CTATGGCAACT
CTATGGCAACT -> TATGGCAACTA
TATGGCAACTA -> ATGGCAACTAG
ATGGCAACTAG -> TGGCAACTAGA
TGGCAACTAGA -> GGCAACTAGAC
GGCAACTAGAC -> GCAACTAGACA
GCAACTAGACA -> CAACTAGACAT
CAACTAGACAT -> AACTAGACATA
AACTAGACATA -> ACTAGACATAG
ACTAGACATAG -> CTAGACATAGT
CTAGACATAGT -> TAGACATAGTC
TAGACATAGTC -> AGACATAGTCT
AGACATAGTCT -> GACATAGTCTT
GACATAGTCTT -> ACATAGTCTTT
ACATAGTCTTT -> CATAGTCTTTT
CATAGTCTTTT -> ATAGTCTTTTT
ATAGTCTTTTT -> TAGTCTTTTTT
TAGTCTTTTTT -> AGTCTTTTTTA
AGTCTTTTTTA -> GTCTTTTTTAG
GTCTTTTTTAG -> TCTTTTTTAGA
TCTTTTTTAGA -> CTTTTTTAGAT
CTTTTTTAGAT -> TTTTTTAGATA
TTTTTTAGATA -> TTTTTAGATAA
TTTTTAGATAA -> TTTTAGATAAA
TTTTAGATAAA -> TTTAGATAAAC
TTTAGATAAAC -> TTAGATAAACA
TTAGATAAACA -> TAGATAAACAT
TAGATAAACAT -> AGATAAACATT
AGATAAACATT -> GATAAACATTG
GATAAACATTG -> ATAAACATTGT
ATAAACATTGT -> TAAACATTGTG
TAAACATTGTG -> AAACATTGTGA
AAACATTGTGA -> AACATTGTGAT
AACATTGTGAT -> ACATTGTGATA
ACATTGTGATA -> CATTGTGATAT
CATTGTGATAT -> ATTGTGATATA
ATTGTGATATA -> TTGTGATATAA
TTGTGATATAA -> TGTGATATAAA
TGTGATATAAA -> GTGATATAAAG
GTGATATAAAG -> TGATATAAAGC
TGATATAAAGC -> GATATAAAGCG
GATATAAAGCG -> ATATAAAGCGA
ATATAAAGCGA -> TATAAAGCGAG
TATAAAGCGAG -> ATAAAGCGAGA
ATAAAGCGAGA -> TAAAGCGAGAA
TAAAGCGAGAA -> AAAGCGAGAAA
AAAGCGAGAAA -> AAGCGAGAAAA
AAGCGAGAAAA -> AGCGAGAAAAA
AGCGAGAAAAA -> GCGAGAAAAAA
GCGAGAAAAAA -> CGAGAAAAAAG
CGAGAAAAAAG -> GAGAAAAAAGC
GAGAAAAAAGC -> AGAAAAAAGCT
AGAAAAAAGCT -> GAAAAAAGCTT
GAAAAAAGCTT -> AAAAAAGCTTT
AAAAAAGCTTT -> AAAAAGCTTTT
AAAAAGCTTTT -> AAAAGCTTTTA
AAAAGCTTTTA -> AAAGCTTTTAC
AAAGCTTTTAC -> AAGCTTTTACT
AAGCTTTTACT -> AGCTTTTACTC
AGCTTTTACTC -> GCTTTTACTCC
GCTTTTACTCC -> CTTTTACTCCT
CTTTTACTCCT -> TTTTACTCCTC
TTTTACTCCTC -> TTTACTCCTCA
TTTACTCCTCA -> TTACTCCTCAA
TTACTCCTCAA -> TACTCCTCAAC
TACTCCTCAAC -> ACTCCTCAACG
ACTCCTCAACG -> CTCCTCAACGC
CTCCTCAACGC -> TCCTCAACGCA
TCCTCAACGCA -> CCTCAACGCAC
CCTCAACGCAC -> CTCAACGCACG
CTCAACGCACG -> TCAACGCACGG
TCAACGCACGG -> CAACGCACGGG
CAACGCACGGG -> AACGCACGGGA
AACGCACGGGA -> ACGCACGGGAA
ACGCACGGGAA -> CGCACGGGAAA
CGCACGGGAAA -> GCACGGGAAAA
GCACGGGAAAA -> CACGGGAAAAT
CACGGGAAAAT -> ACGGGAAAATG
ACGGGAAAATG -> CGGGAAAATGA
CGGGAAAATGA -> GGGAAAATGAG
GGGAAAATGAG -> GGAAAATGAGA
GGAAAATGAGA -> GAAAATGAGAA
GAAAATGAGAA -> AAAATGAGAAT
AAAATGAGAAT -> AAATGAGAATT
AAATGAGAATT -> AATGAGAATTA
AATGAGAATTA -> ATGAGAATTAG
ATGAGAATTAG -> TGAGAATTAGG
TGAGAATTAGG -> GAGAATTAGGG
GAGAATTAGGG -> AGAATTAGGGG
AGAATTAGGGG -> GAATTAGGGGC
GAATTAGGGGC -> AATTAGGGGCG
AATTAGGGGCG -> ATTAGGGGCGT
ATTAGGGGCGT -> TTAGGGGCGTT
TTAGGGGCGTT -> TAGGGGCGTTA
TAGGGGCGTTA -> AGGGGCGTTAT
AGGGGCGTTAT -> GGGGCGTTATA
GGGGCGTTATA -> GGGCGTTATAG
GGGCGTTATAG -> GGCGTTATAGC
GGCGTTATAGC -> GCGTTATAGCT
GCGTTATAGCT -> CGTTATAGCTA
CGTTATAGCTA -> GTTATAGCTAG
GTTATAGCTAG -> TTATAGCTAGG
TTATAGCTAGG -> TATAGCTAGGA
TATAGCTAGGA -> ATAGCTAGGAC
ATAGCTAGGAC -> TAGCTAGGACA
TAGCTAGGACA -> AGCTAGGACAC
AGCTAGGACAC -> GCTAGGACACT
GCTAGGACACT -> CTAGGACACTA
CTAGGACACTA -> TAGGACACTAT
TAGGACACTAT -> AGGACACTATG
AGGACACTATG -> GGACACTATGA
GGACACTATGA -> GACACTATGAA
GACACTATGAA -> ACACTATGAAT
ACACTATGAAT -> CACTATGAATA
CACTATGAATA -> ACTATGAATAC
ACTATGAATAC -> CTATGAATACG
CTATGAATACG -> TATGAATACGC
TATGAATACGC -> ATGAATACGCA
ATGAATACGCA -> TGAATACGCAG
TGAATACGCAG -> GAATACGCAGG
GAATACGCAGG -> AATACGCAGGT
AATACGCAGGT -> ATACGCAGGTA
ATACGCAGGTA -> TACGCAGGTAT
TACGCAGGTAT -> ACGCAGGTATA
ACGCAGGTATA -> CGCAGGTATAA
CGCAGGTATAA -> GCAGGTATAAG
GCAGGTATAAG -> CAGGTATAAGA
CAGGTATAAGA -> AGGTATAAGAA
AGGTATAAGAA -> GGTATAAGAAG
GGTATAAGAAG -> GTATAAGAAGC
GTATAAGAAGC -> TATAAGAAGCA
TATAAGAAGCA -> ATAAGAAGCAC
ATAAGAAGCAC -> TAAGAAGCACA
TAAGAAGCACA -> AAGAAGCACAC
AAGAAGCACAC -> AGAAGCACACT
AGAAGCACACT -> GAAGCACACTG
GAAGCACACTG -> AAGCACACTGA
AAGCACACTGA -> AGCACACTGAT
AGCACACTGAT -> GCACACTGATT
GCACACTGATT -> CACACTGATTG
CACACTGATTG -> ACACTGATTGC
ACACTGATTGC -> CACTGATTGCG
CACTGATTGCG -> ACTGATTGCGG
ACTGATTGCGG -> CTGATTGCGGC
CTGATTGCGGC -> TGATTGCGGCT
TGATTGCGGCT -> GATTGCGGCTG
GATTGCGGCTG -> ATTGCGGCTGC
ATTGCGGCTGC -> TTGCGGCTGCC
TTGCGGCTGCC -> TGCGGCTGCCT
TGCGGCTGCCT -> GCGGCTGCCTT
GCGGCTGCCTT -> CGGCTGCCTTG
CGGCTGCCTTG -> GGCTGCCTTGA
GGCTGCCTTGA -> GCTGCCTTGAT
GCTGCCTTGAT -> CTGCCTTGATT
CTGCCTTGATT -> TGCCTTGATTC
TGCCTTGATTC -> GCCTTGATTCT
GCCTTGATTCT -> CCTTGATTCTA
CCTTGATTCTA -> CTTGATTCTAT
CTTGATTCTAT -> TTGATTCTATA
TTGATTCTATA -> TGATTCTATAG
TGATTCTATAG -> GATTCTATAGT
GATTCTATAGT -> ATTCTATAGTA
ATTCTATAGTA -> TTCTATAGTAT
TTCTATAGTAT -> TCTATAGTATC
TCTATAGTATC -> CTATAGTATCA
CTATAGTATCA -> TATAGTATCAG
TATAGTATCAG -> ATAGTATCAGA
ATAGTATCAGA -> TAGTATCAGAA
TAGTATCAGAA -> AGTATCAGAAA
AGTATCAGAAA -> GTATCAGAAAC
GTATCAGAAAC -> TATCAGAAACG
TATCAGAAACG -> ATCAGAAACGT
ATCAGAAACGT -> TCAGAAACGTG
TCAGAAACGTG -> CAGAAACGTGG
CAGAAACGTGG -> AGAAACGTGGC
AGAAACGTGGC -> GAAACGTGGCC
GAAACGTGGCC -> AAACGTGGCCG
AAACGTGGCCG -> AACGTGGCCGG
AACGTGGCCGG -> ACGTGGCCGGA
ACGTGGCCGGA -> CGTGGCCGGAA
CGTGGCCGGAA -> GTGGCCGGAAG
GTGGCCGGAAG -> TGGCCGGAAGC
TGGCCGGAAGC -> GGCCGGAAGCC
GGCCGGAAGCC -> GCCGGAAGCCG
GCCGGAAGCCG -> CCGGAAGCCGC
CCGGAAGCCGC -> CGGAAGCCGCA
CGGAAGCCGCA -> GGAAGCCGCAT
GGAAGCCGCAT -> GAAGCCGCATA
GAAGCCGCATA -> AAGCCGCATAT
AAGCCGCATAT -> AGCCGCATATC
AGCCGCATATC -> GCCGCATATCG
GCCGCATATCG -> CCGCATATCGC
CCGCATATCGC -> CGCATATCGCT
CGCATATCGCT -> GCATATCGCTA
GCATATCGCTA -> CATATCGCTAA
CATATCGCTAA -> ATATCGCTAAC
ATATCGCTAAC -> TATCGCTAACG
TATCGCTAACG -> ATCGCTAACGG
ATCGCTAACGG -> TCGCTAACGGT
TCGCTAACGGT -> CGCTAACGGTC
CGCTAACGGTC -> GCTAACGGTCG
GCTAACGGTCG -> CTAACGGTCGT
CTAACGGTCGT -> TAACGGTCGTC
TAACGGTCGTC -> AACGGTCGTCT
AACGGTCGTCT -> ACGGTCGTCTG
ACGGTCGTCTG -> CGGTCGTCTGC
CGGTCGTCTGC -> GGTCGTCTGCT
GGTCGTCTGCT -> GTCGTCTGCTC
GTCGTCTGCTC -> TCGTCTGCTCC
TCGTCTGCTCC -> CGTCTGCTCCC
CGTCTGCTCCC -> GTCTGCTCCCC
GTCTGCTCCCC -> TCTGCTCCCCG
TCTGCTCCCCG -> CTGCTCCCCGA
CTGCTCCCCGA -> TGCTCCCCGAC
TGCTCCCCGAC -> GCTCCCCGACA
GCTCCCCGACA -> CTCCCCGACAC
CTCCCCGACAC -> TCCCCGACACT
TCCCCGACACT -> CCCCGACACTT
CCCCGACACTT -> CCCGACACTTG
CCCGACACTTG -> CCGACACTTGT
CCGACACTTGT -> CGACACTTGTG
CGACACTTGTG -> GACACTTGTGA
GACACTTGTGA -> ACACTTGTGAC
ACACTTGTGAC -> CACTTGTGACA
CACTTGTGACA -> ACTTGTGACAT
ACTTGTGACAT -> CTTGTGACATC
CTTGTGACATC -> TTGTGACATCC
TTGTGACATCC -> TGTGACATCCC
TGTGACATCCC -> GTGACATCCCA
GTGACATCCCA -> TGACATCCCAT
TGACATCCCAT -> GACATCCCATG
GACATCCCATG -> ACATCCCATGT
ACATCCCATGT -> CATCCCATGTG
CATCCCATGTG -> ATCCCATGTGA
ATCCCATGTGA -> TCCCATGTGAG
TCCCATGTGAG -> CCCATGTGAGG
CCCATGTGAGG -> CCATGTGAGGT
CCATGTGAGGT -> CATGTGAGGTG
CATGTGAGGTG -> ATGTGAGGTGG
ATGTGAGGTGG -> TGTGAGGTGGG
TGTGAGGTGGG -> GTGAGGTGGGG
GTGAGGTGGGG -> TGAGGTGGGGC
TGAGGTGGGGC -> GAGGTGGGGCA
GAGGTGGGGCA -> AGGTGGGGCAA
AGGTGGGGCAA -> GGTGGGGCAAA
GGTGGGGCAAA -> GTGGGGCAAAT
GTGGGGCAAAT -> TGGGGCAAATC
TGGGGCAAATC -> GGGGCAAATCT
GGGGCAAATCT -> GGGCAAATCTC
GGGCAAATCTC -> GGCAAATCTCC
GGCAAATCTCC -> GCAAATCTCCC
GCAAATCTCCC -> CAAATCTCCCA
CAAATCTCCCA -> AAATCTCCCAC
AAATCTCCCAC -> AATCTCCCACC
AATCTCCCACC -> ATCTCCCACCA
ATCTCCCACCA -> TCTCCCACCAG
TCTCCCACCAG -> CTCCCACCAGA
CTCCCACCAGA -> TCCCACCAGAA
TCCCACCAGAA -> CCCACCAGAAT
CCCACCAGAAT -> CCACCAGAATG
CCACCAGAATG -> CACCAGAATGG
CACCAGAATGG -> ACCAGAATGGA
ACCAGAATGGA -> CCAGAATGGAT
